time_measured,estimation_time,time_diff_seconds,predicted_temp_f,actual_temp_f,diff_f
1637887835,1637888400,565,35.836,35.71,0.126
1637887835,1637892000,4165,34.972,33.69,1.282
1637887835,1637895600,7765,33.748,31.55,2.198
1637887835,1637899200,11365,31.822,29.75,2.072
1637410617,1637413200,2583,42.294,48.42,-6.126
1637410617,1637416800,6183,45.75,56.75,-11.0
1637410617,1637420400,9783,50.016,48.54,1.476
1637410617,1637424000,13383,55.362,50.67,4.692
1637833575,1637834400,825,44.53,44.15,0.38
1637833575,1637838000,4425,45.43,43.59,1.84
1637833575,1637841600,8025,46.546,44.6,1.946
1637833575,1637845200,11625,48.22,43.36,4.86
1637956469,1637956800,331,43.952,43.36,0.592
1637956469,1637960400,3931,43.358,42.58,0.778
1637956469,1637964000,7531,41.522,41.79,-0.268
1637956469,1637967600,11131,39.434,41.11,-1.676
1637938408,1637938800,392,66.598,70.14,-3.542
1637938408,1637942400,3992,65.914,75.76,-9.846
1637938408,1637946000,7592,65.5,74.07,-8.57
1637938408,1637949600,11192,64.996,48.2,16.796
1637173826,1637175600,1774,65.07,64.85,0.22
1637173826,1637179200,5374,64.926,62.6,2.326
1637173826,1637182800,8974,63.018,61.14,1.878
1637173826,1637186400,12574,58.05,56.97,1.08
1637320203,1637323200,2997,28.326,34.47,-6.144
1637320203,1637326800,6597,27.354,39.54,-12.186
1637320203,1637330400,10197,27.678,47.75,-20.072
1637320203,1637334000,13797,29.154,46.96,-17.806
1637352791,1637355600,2809,42.892,41.0,1.892
1637352791,1637359200,6409,40.516,39.76,0.756
1637352791,1637362800,10009,37.942,37.29,0.652
1637352791,1637366400,13609,35.062,35.38,-0.318
1637703517,1637704800,1283,38.712,38.3,0.412
1637703517,1637708400,4883,37.128,36.61,0.518
1637703517,1637712000,8483,34.914,35.49,-0.576
1637703517,1637715600,12083,32.43,36.72,-4.29
1637793830,1637794800,970,50.72,52.25,-1.53
1637793830,1637798400,4570,49.784,53.26,-3.476
1637793830,1637802000,8170,48.344,52.36,-4.016
1637793830,1637805600,11770,46.868,51.46,-4.592
1637181076,1637182800,1724,61.7,61.14,0.56
1637181076,1637186400,5324,59.324,56.97,2.354
1637181076,1637190000,8924,55.778,54.95,0.828
1637181076,1637193600,12524,52.052,51.46,0.592
1637642049,1637643600,1551,27.212,27.5,-0.288
1637642049,1637647200,5151,26.258,27.39,-1.132
1637642049,1637650800,8751,24.926,27.39,-2.464
1637642049,1637654400,12351,23.126,27.5,-4.374
1637461252,1637463600,2348,45.628,45.5,0.128
1637461252,1637467200,5948,45.61,45.84,-0.23
1637461252,1637470800,9548,45.358,45.28,0.078
1637461252,1637474400,13148,46.15,45.72,0.43
1638010656,1638010800,144,33.8,33.35,0.45
1638010656,1638014400,3744,33.548,36.95,-3.402
1638010656,1638018000,7344,34.304,43.59,-9.286
1638010656,1638021600,10944,37.634,72.16,-34.526
1637294901,1637298000,3099,29.442,30.09,-0.648
1637294901,1637301600,6699,28.128,29.19,-1.062
1637294901,1637305200,10299,26.364,28.63,-2.266
1637294901,1637308800,13899,24.384,28.96,-4.576
1637338274,1637341200,2926,53.992,60.57,-6.578
1637338274,1637344800,6526,54.946,48.99,5.956
1637338274,1637348400,10126,56.098,46.17,9.928
1637338274,1637352000,13726,56.746,43.59,13.156
1637942020,1637942400,380,77.506,75.76,1.746
1637942020,1637946000,3980,76.822,74.07,2.752
1637942020,1637949600,7580,76.174,48.2,27.974
1637942020,1637953200,11180,75.202,44.49,30.712
1637407004,1637409600,2596,36.354,41.11,-4.756
1637407004,1637413200,6196,38.154,48.42,-10.266
1637407004,1637416800,9796,42.672,56.75,-14.078
1637407004,1637420400,13396,47.64,48.54,-0.9
1637166583,1637168400,1817,102.216,98.04,4.176
1637166583,1637172000,5417,104.322,66.65,37.672
1637166583,1637175600,9017,106.482,64.85,41.632
1637166583,1637179200,12617,107.76,62.6,45.16
1637450414,1637452800,2386,44.582,45.28,-0.698
1637450414,1637456400,5986,43.34,44.94,-1.6
1637450414,1637460000,9586,41.63,45.16,-3.53
1637450414,1637463600,13186,39.938,45.5,-5.562
1637486538,1637488800,2262,45.716,43.59,2.126
1637486538,1637492400,5862,45.932,43.81,2.122
1637486538,1637496000,9462,46.544,43.59,2.954
1637486538,1637499600,13062,49.586,48.31,1.276
1637732423,1637733600,1177,36.932,37.63,-0.698
1637732423,1637737200,4777,37.112,37.63,-0.518
1637732423,1637740800,8377,37.31,35.94,1.37
1637732423,1637744400,11977,37.4,36.84,0.56
1637472090,1637474400,2310,46.328,45.72,0.608
1637472090,1637478000,5910,46.832,45.84,0.992
1637472090,1637481600,9510,48.2,46.06,2.14
1637472090,1637485200,13110,49.226,45.61,3.616
1637801054,1637802000,946,52.752,52.36,0.392
1637801054,1637805600,4546,52.716,51.46,1.256
1637801054,1637809200,8146,52.572,51.01,1.562
1637801054,1637812800,11746,52.446,50.22,2.226
1637674619,1637676000,1381,-194.368,72.05,-266.418
1637674619,1637679600,4981,-193.684,82.18,-275.864
1637674619,1637683200,8581,-192.046,87.13,-279.176
1637674619,1637686800,12181,-189.832,82.18,-272.012
1637992594,1637992800,206,37.562,37.17,0.392
1637992594,1637996400,3806,37.148,37.17,-0.022
1637992594,1638000000,7406,36.536,34.36,2.176
1637992594,1638003600,11006,35.87,34.14,1.73
1637829960,1637830800,840,46.614,45.61,1.004
1637829960,1637834400,4440,47.046,44.15,2.896
1637829960,1637838000,8040,48.45,43.59,4.86
1637829960,1637841600,11640,49.674,44.6,5.074
1637555290,1637557200,1910,32.596,31.44,1.156
1637555290,1637560800,5510,32.182,29.86,2.322
1637555290,1637564400,9110,32.47,30.76,1.71
1637555290,1637568000,12710,32.776,29.41,3.366
1637620372,1637622000,1628,31.122,31.77,-0.648
1637620372,1637625600,5228,29.772,29.86,-0.088
1637620372,1637629200,8828,27.99,28.96,-0.97
1637620372,1637632800,12428,25.2,28.17,-2.97
1637569799,1637571600,1801,29.086,29.08,0.006
1637569799,1637575200,5401,29.05,27.84,1.21
1637569799,1637578800,9001,29.104,28.96,0.144
1637569799,1637582400,12601,27.97,33.46,-5.49
1637876998,1637877600,602,35.384,36.16,-0.776
1637876998,1637881200,4202,34.196,35.15,-0.954
1637876998,1637884800,7802,32.684,35.6,-2.916
1637876998,1637888400,11402,31.028,35.71,-4.682
1637685456,1637686800,1344,89.902,82.18,7.722
1637685456,1637690400,4944,90.37,52.47,37.9
1637685456,1637694000,8544,90.838,50.22,40.618
1637685456,1637697600,12144,91.18,46.96,44.22
1637858930,1637859600,670,76.12,74.3,1.82
1637858930,1637863200,4270,76.606,47.19,29.416
1637858930,1637866800,7870,77.848,45.05,32.798
1637858930,1637870400,11470,78.748,40.55,38.198
1638017881,1638018000,119,44.1,43.59,0.51
1638017881,1638021600,3719,45.54,72.16,-26.62
1638017881,1638025200,7319,48.6,83.19,-34.59
1638017881,1638028800,10919,53.046,81.5,-28.454
1637913121,1637913600,479,26.722,27.05,-0.328
1637913121,1637917200,4079,26.02,26.38,-0.36
1637913121,1637920800,7679,24.238,26.6,-2.362
1637913121,1637924400,11279,22.258,25.81,-3.552
1637323817,1637326800,2983,34.002,39.54,-5.538
1637323817,1637330400,6583,34.11,47.75,-13.64
1637323817,1637334000,10183,35.406,46.96,-11.554
1637323817,1637337600,13783,37.548,48.09,-10.542
1637533558,1637535600,2042,40.066,39.65,0.416
1637533558,1637539200,5642,39.418,37.96,1.458
1637533558,1637542800,9242,38.644,36.05,2.594
1637533558,1637546400,12842,37.474,34.25,3.224
1637739646,1637740800,1154,36.556,35.94,0.616
1637739646,1637744400,4754,37.042,36.84,0.202
1637739646,1637748000,8354,37.474,35.83,1.644
1637739646,1637751600,11954,37.96,34.47,3.49
1637855317,1637856000,683,-194.998,77.68,-272.678
1637855317,1637859600,4283,-193.918,74.3,-268.218
1637855317,1637863200,7883,-191.938,47.19,-239.128
1637855317,1637866800,11483,-189.292,45.05,-234.342
1638003431,1638003600,169,33.906,34.14,-0.234
1638003431,1638007200,3769,33.474,33.69,-0.216
1638003431,1638010800,7369,32.898,33.35,-0.452
1638003431,1638014400,10969,32.25,36.95,-4.7
1637573411,1637575200,1789,28.56,27.84,0.72
1637573411,1637578800,5389,28.596,28.96,-0.364
1637573411,1637582400,8989,28.056,33.46,-5.404
1637573411,1637586000,12589,27.912,37.63,-9.718
1637927571,1637928000,429,28.344,28.85,-0.506
1637927571,1637931600,4029,27.03,32.34,-5.31
1637927571,1637935200,7629,25.77,56.3,-30.53
1637927571,1637938800,11229,24.258,70.14,-45.882
1637519049,1637521200,2151,52.88,47.41,5.47
1637519049,1637524800,5751,52.79,44.49,8.3
1637519049,1637528400,9351,51.584,41.79,9.794
1637519049,1637532000,12951,48.938,40.33,8.608
1637544393,1637546400,2007,34.752,34.25,0.502
1637544393,1637550000,5607,34.662,33.01,1.652
1637544393,1637553600,9207,34.77,31.77,3.0
1637544393,1637557200,12807,34.086,31.44,2.646
1637804667,1637805600,933,51.98,51.46,0.52
1637804667,1637809200,4533,52.106,51.01,1.096
1637804667,1637812800,8133,52.232,50.22,2.012
1637804667,1637816400,11733,52.538,49.21,3.328
1637681844,1637683200,1356,88.608,87.13,1.478
1637681844,1637686800,4956,89.256,82.18,7.076
1637681844,1637690400,8556,90.3,52.47,37.83
1637681844,1637694000,12156,91.146,50.22,40.926
1637425128,1637427600,2472,50.922,50.11,0.812
1637425128,1637431200,6072,52.488,49.55,2.938
1637425128,1637434800,9672,54.36,48.88,5.48
1637425128,1637438400,13272,55.62,47.41,8.21
1637170203,1637172000,1797,72.158,66.65,5.508
1637170203,1637175600,5397,72.95,64.85,8.1
1637170203,1637179200,8997,73.148,62.6,10.548
1637170203,1637182800,12597,70.556,61.14,9.416
1637974533,1637974800,267,39.902,39.76,0.142
1637974533,1637978400,3867,38.768,39.31,-0.542
1637974533,1637982000,7467,37.508,37.85,-0.342
1637974533,1637985600,11067,36.14,36.16,-0.02
1637334660,1637337600,2940,49.964,48.09,1.874
1637334660,1637341200,6540,50.882,60.57,-9.688
1637334660,1637344800,10140,52.34,48.99,3.35
1637334660,1637348400,13740,53.87,46.17,7.7
1637428740,1637431200,2460,51.148,49.55,1.598
1637428740,1637434800,6060,52.3,48.88,3.42
1637428740,1637438400,9660,53.128,47.41,5.718
1637428740,1637442000,13260,52.66,45.84,6.82
1637548006,1637550000,1994,33.274,33.01,0.264
1637548006,1637553600,5594,33.148,31.77,1.378
1637548006,1637557200,9194,32.5,31.44,1.06
1637548006,1637560800,12794,31.888,29.86,2.028
1637692680,1637694000,1320,50.612,50.22,0.392
1637692680,1637697600,4920,50.378,46.96,3.418
1637692680,1637701200,8520,49.37,42.13,7.24
1637692680,1637704800,12120,45.752,38.3,7.452
1637815509,1637816400,891,49.942,49.21,0.732
1637815509,1637820000,4491,50.014,47.97,2.044
1637815509,1637823600,8091,50.284,45.05,5.234
1637815509,1637827200,11691,50.572,45.61,4.962
1637826346,1637827200,854,47.048,45.61,1.438
1637826346,1637830800,4454,47.48,45.61,1.87
1637826346,1637834400,8054,47.822,44.15,3.672
1637826346,1637838000,11654,49.658,43.59,6.068
1637595084,1637596800,1716,87.69,84.99,2.7
1637595084,1637600400,5316,87.672,81.84,5.832
1637595084,1637604000,8916,87.186,47.19,39.996
1637595084,1637607600,12516,85.944,42.35,43.594
1637613147,1637614800,1653,37.366,36.84,0.526
1637613147,1637618400,5253,35.908,33.24,2.668
1637613147,1637622000,8853,33.586,31.77,1.816
1637613147,1637625600,12453,30.976,29.86,1.116
1637529946,1637532000,2054,40.55,40.33,0.22
1637529946,1637535600,5654,39.56,39.65,-0.09
1637529946,1637539200,9254,38.534,37.96,0.574
1637529946,1637542800,12854,37.364,36.05,1.314
1637768545,1637769600,1055,85.874,80.49,5.384
1637768545,1637773200,4655,87.296,85.44,1.856
1637768545,1637776800,8255,89.492,61.36,28.132
1637768545,1637780400,11855,92.066,58.89,33.176
1637566127,1637568000,1873,30.234,29.41,0.824
1637566127,1637571600,5473,30.396,29.08,1.316
1637566127,1637575200,9073,30.342,27.84,2.502
1637566127,1637578800,12673,30.396,28.96,1.436
1637988981,1637989200,219,37.51,36.72,0.79
1637988981,1637992800,3819,36.772,37.17,-0.398
1637988981,1637996400,7419,35.998,37.17,-1.172
1637988981,1638000000,11019,34.612,34.36,0.252
1637699906,1637701200,1294,43.376,42.13,1.246
1637699906,1637704800,4894,42.008,38.3,3.708
1637699906,1637708400,8494,39.182,36.61,2.572
1637699906,1637712000,12094,36.122,35.49,0.632
1637399781,1637402400,2619,37.47,36.28,1.19
1637399781,1637406000,6219,38.568,34.92,3.648
1637399781,1637409600,9819,39.144,41.11,-1.966
1637399781,1637413200,13419,41.844,48.42,-6.576
1637341889,1637344800,2911,62.622,48.99,13.632
1637341889,1637348400,6511,63.288,46.17,17.118
1637341889,1637352000,10111,63.666,43.59,20.076
1637341889,1637355600,13711,62.766,41.0,21.766
1637898671,1637899200,529,30.166,29.75,0.416
1637898671,1637902800,4129,29.068,28.74,0.328
1637898671,1637906400,7729,27.394,28.51,-1.116
1637898671,1637910000,11329,25.486,27.5,-2.014
1637497374,1637499600,2226,46.076,48.31,-2.234
1637497374,1637503200,5826,49.01,74.64,-25.63
1637497374,1637506800,9426,53.24,84.65,-31.41
1637497374,1637510400,13026,59.162,56.97,2.192
1637479314,1637481600,2286,46.35,46.06,0.29
1637479314,1637485200,5886,46.782,45.61,1.172
1637479314,1637488800,9486,47.052,43.59,3.462
1637479314,1637492400,13086,46.98,43.81,3.17
1637663782,1637665200,1418,27.66,27.05,0.61
1637663782,1637668800,5018,26.958,30.99,-4.032
1637663782,1637672400,8618,27.462,37.17,-9.708
1637663782,1637676000,12218,30.072,72.05,-41.978
1637746870,1637748000,1130,36.248,35.83,0.418
1637746870,1637751600,4730,36.752,34.47,2.282
1637746870,1637755200,8330,37.274,39.31,-2.036
1637746870,1637758800,11930,39.848,47.75,-7.902
1637587860,1637589600,1740,63.916,68.56,-4.644
1637587860,1637593200,5340,64.906,81.72,-16.814
1637587860,1637596800,8940,65.788,84.99,-19.202
1637587860,1637600400,12540,66.526,81.84,-15.314
1637822734,1637823600,866,45.822,45.05,0.772
1637822734,1637827200,4466,46.146,45.61,0.536
1637822734,1637830800,8066,46.884,45.61,1.274
1637822734,1637834400,11666,47.28,44.15,3.13
1637645661,1637647200,1539,28.092,27.39,0.702
1637645661,1637650800,5139,27.318,27.39,-0.072
1637645661,1637654400,8739,26.094,27.5,-1.406
1637645661,1637658000,12339,24.672,26.83,-2.158
1637177446,1637179200,1754,-196.6,62.6,-259.2
1637177446,1637182800,5354,-197.86,61.14,-259.0
1637177446,1637186400,8954,-201.73,56.97,-258.7
1637177446,1637190000,12554,-206.068,54.95,-261.018
1637388945,1637391600,2655,38.48,38.08,0.4
1637388945,1637395200,6255,38.858,37.29,1.568
1637388945,1637398800,9855,39.29,37.06,2.23
1637388945,1637402400,13455,39.434,36.28,3.154
1637667394,1637668800,1406,29.962,30.99,-1.028
1637667394,1637672400,5006,29.8,37.17,-7.37
1637667394,1637676000,8606,31.456,72.05,-40.594
1637667394,1637679600,12206,34.03,82.18,-48.15
1637967308,1637967600,292,41.688,41.11,0.578
1637967308,1637971200,3892,40.914,41.56,-0.646
1637967308,1637974800,7492,39.798,39.76,0.038
1637967308,1637978400,11092,38.304,39.31,-1.006
1637660169,1637661600,1431,27.138,26.38,0.758
1637660169,1637665200,5031,26.598,27.05,-0.452
1637660169,1637668800,8631,25.968,30.99,-5.022
1637660169,1637672400,12231,27.174,37.17,-9.996
1637508211,1637510400,2189,77.252,56.97,20.282
1637508211,1637514000,5789,79.754,85.32,-5.566
1637508211,1637517600,9389,81.536,54.28,27.256
1637508211,1637521200,12989,83.066,47.41,35.656
1637403393,1637406000,2607,38.028,34.92,3.108
1637403393,1637409600,6207,38.748,41.11,-2.362
1637403393,1637413200,9807,41.034,48.42,-7.386
1637403393,1637416800,13407,46.65,56.75,-10.1
1637378109,1637380800,2691,36.118,35.38,0.738
1637378109,1637384400,6291,35.776,37.17,-1.394
1637378109,1637388000,9891,35.398,37.74,-2.342
1637378109,1637391600,13491,34.912,38.08,-3.168
1637960082,1637960400,318,42.874,42.58,0.294
1637960082,1637964000,3918,41.722,41.79,-0.068
1637960082,1637967600,7518,39.994,41.11,-1.116
1637960082,1637971200,11118,37.834,41.56,-3.726
1637511824,1637514000,2176,70.918,85.32,-14.402
1637511824,1637517600,5776,72.214,54.28,17.934
1637511824,1637521200,9376,73.276,47.41,25.866
1637511824,1637524800,12976,73.042,44.49,28.552
1637360017,1637362800,2783,38.592,37.29,1.302
1637360017,1637366400,6383,37.026,35.38,1.646
1637360017,1637370000,9983,34.686,36.05,-1.364
1637360017,1637373600,13583,32.328,36.16,-3.832
1637331045,1637334000,2955,50.704,46.96,3.744
1637331045,1637337600,6555,51.568,48.09,3.478
1637331045,1637341200,10155,53.206,60.57,-7.364
1637331045,1637344800,13755,55.258,48.99,6.268
1638014268,1638014400,132,37.566,36.95,0.616
1638014268,1638018000,3732,37.89,43.59,-5.7
1638014268,1638021600,7332,40.266,72.16,-31.894
1638014268,1638025200,10932,44.082,83.19,-39.108
1637895060,1637895600,540,31.946,31.55,0.396
1637895060,1637899200,4140,30.848,29.75,1.098
1637895060,1637902800,7740,29.426,28.74,0.686
1637895060,1637906400,11340,27.338,28.51,-1.172
1637396169,1637398800,2631,38.1,37.06,1.04
1637396169,1637402400,6231,38.532,36.28,2.252
1637396169,1637406000,9831,39.594,34.92,4.674
1637396169,1637409600,13431,39.81,41.11,-1.3
1637873386,1637874000,614,36.358,36.39,-0.032
1637873386,1637877600,4214,34.594,36.16,-1.566
1637873386,1637881200,7814,32.812,35.15,-2.338
1637873386,1637884800,11414,30.562,35.6,-5.038
1637916734,1637917200,466,27.246,26.38,0.866
1637916734,1637920800,4066,26.22,26.6,-0.38
1637916734,1637924400,7666,24.708,25.81,-1.102
1637916734,1637928000,11266,21.288,28.85,-7.562
1637298515,1637301600,3085,29.07,29.19,-0.12
1637298515,1637305200,6685,27.864,28.63,-0.766
1637298515,1637308800,10285,26.37,28.96,-2.59
1637298515,1637312400,13885,24.48,28.51,-4.03
1637504599,1637506800,2201,81.306,84.65,-3.344
1637504599,1637510400,5801,84.51,56.97,27.54
1637504599,1637514000,9401,88.686,85.32,3.366
1637504599,1637517600,13001,91.512,54.28,37.232
1637786605,1637787600,995,53.888,52.7,1.188
1637786605,1637791200,4595,52.016,52.59,-0.574
1637786605,1637794800,8195,49.244,52.25,-3.006
1637786605,1637798400,11795,46.022,53.26,-7.238
1637902284,1637902800,516,29.302,28.74,0.562
1637902284,1637906400,4116,28.168,28.51,-0.342
1637902284,1637910000,7716,26.674,27.5,-0.826
1637902284,1637913600,11316,25.342,27.05,-1.708
1637808280,1637809200,920,51.688,51.01,0.678
1637808280,1637812800,4520,51.634,50.22,1.414
1637808280,1637816400,8120,51.706,49.21,2.496
1637808280,1637820000,11720,51.652,47.97,3.682
1638007044,1638007200,156,33.76,33.69,0.07
1638007044,1638010800,3756,33.256,33.35,-0.094
1638007044,1638014400,7356,32.662,36.95,-4.288
1638007044,1638018000,10956,33.652,43.59,-9.938
1637432353,1637434800,2447,50.198,48.88,1.318
1637432353,1637438400,6047,50.63,47.41,3.22
1637432353,1637442000,9647,50.054,45.84,4.214
1637432353,1637445600,13247,46.112,45.5,0.612
1637162962,1637164800,1838,99.14,100.4,-1.26
1637162962,1637168400,5438,102.272,98.04,4.232
1637162962,1637172000,9038,105.71,66.65,39.06
1637162962,1637175600,12638,109.022,64.85,44.172
1637996206,1637996400,194,38.082,37.17,0.912
1637996206,1638000000,3794,37.578,34.36,3.218
1637996206,1638003600,7394,36.966,34.14,2.826
1637996206,1638007200,10994,36.084,33.69,2.394
1637851704,1637852400,696,68.862,68.11,0.752
1637851704,1637856000,4296,70.716,77.68,-6.964
1637851704,1637859600,7896,73.722,74.3,-0.578
1637851704,1637863200,11496,77.484,47.19,30.294
1637710750,1637712000,1250,35.384,35.49,-0.106
1637710750,1637715600,4850,34.16,36.72,-2.56
1637710750,1637719200,8450,32.684,37.4,-4.716
1637710750,1637722800,12050,31.082,35.49,-4.408
1637891447,1637892000,553,32.706,33.69,-0.984
1637891447,1637895600,4153,31.77,31.55,0.22
1637891447,1637899200,7753,30.258,29.75,0.508
1637891447,1637902800,11353,28.566,28.74,-0.174
1637370881,1637373600,2719,35.816,36.16,-0.344
1637370881,1637377200,6319,35.114,35.94,-0.826
1637370881,1637380800,9919,33.782,35.38,-1.598
1637370881,1637384400,13519,32.342,37.17,-4.828
1637909508,1637910000,492,27.824,27.5,0.324
1637909508,1637913600,4092,26.834,27.05,-0.216
1637909508,1637917200,7692,25.556,26.38,-0.824
1637909508,1637920800,11292,22.784,26.6,-3.816
1637302130,1637305200,3070,28.794,28.63,0.164
1637302130,1637308800,6670,27.876,28.96,-1.084
1637302130,1637312400,10270,26.508,28.51,-2.002
1637302130,1637316000,13870,24.51,27.84,-3.33
1637949245,1637949600,355,50.56,48.2,2.36
1637949245,1637953200,3955,49.984,44.49,5.494
1637949245,1637956800,7555,48.958,43.36,5.598
1637949245,1637960400,11155,46.852,42.58,4.272
1637482925,1637485200,2275,46.614,45.61,1.004
1637482925,1637488800,5875,46.74,43.59,3.15
1637482925,1637492400,9475,46.614,43.81,2.804
1637482925,1637496000,13075,46.308,43.59,2.718
1637772157,1637773200,1043,93.258,85.44,7.818
1637772157,1637776800,4643,94.158,61.36,32.798
1637772157,1637780400,8243,95.58,58.89,36.69
1637772157,1637784000,11843,96.696,57.54,39.156
1637605922,1637607600,1678,43.174,42.35,0.824
1637605922,1637611200,5278,41.644,39.2,2.444
1637605922,1637614800,8878,39.286,36.84,2.446
1637605922,1637618400,12478,35.524,33.24,2.284
1637616759,1637618400,1641,34.11,33.24,0.87
1637616759,1637622000,5241,32.526,31.77,0.756
1637616759,1637625600,8841,30.492,29.86,0.632
1637616759,1637629200,12441,28.044,28.96,-0.916
1637327431,1637330400,2969,41.986,47.75,-5.764
1637327431,1637334000,6569,42.598,46.96,-4.362
1637327431,1637337600,10169,44.128,48.09,-3.962
1637327431,1637341200,13769,46.342,60.57,-14.228
1637656557,1637658000,1443,27.572,26.83,0.742
1637656557,1637661600,5043,26.816,26.38,0.436
1637656557,1637665200,8643,25.97,27.05,-1.08
1637656557,1637668800,12243,25.016,30.99,-5.974
1637920347,1637920800,453,27.3,26.6,0.7
1637920347,1637924400,4053,25.95,25.81,0.14
1637920347,1637928000,7653,23.16,28.85,-5.69
1637920347,1637931600,11253,20.766,32.34,-11.574
1637417903,1637420400,2497,56.28,48.54,7.74
1637417903,1637424000,6097,58.8,50.67,8.13
1637417903,1637427600,9697,62.148,50.11,12.038
1637417903,1637431200,13297,65.892,49.55,16.342
1637558902,1637560800,1898,30.706,29.86,0.846
1637558902,1637564400,5498,30.778,30.76,0.018
1637558902,1637568000,9098,30.976,29.41,1.566
1637558902,1637571600,12698,31.12,29.08,2.04
1637623985,1637625600,1615,30.544,29.86,0.684
1637623985,1637629200,5215,29.284,28.96,0.324
1637623985,1637632800,8815,27.196,28.17,-0.974
1637623985,1637636400,12415,24.55,27.84,-3.29
1637446803,1637449200,2397,44.73,45.5,-0.77
1637446803,1637452800,5997,42.93,45.28,-2.35
1637446803,1637456400,9597,41.094,44.94,-3.846
1637446803,1637460000,13197,38.718,45.16,-6.442
1637985369,1637985600,231,37.738,36.16,1.578
1637985369,1637989200,3831,36.766,36.72,0.046
1637985369,1637992800,7431,35.668,37.17,-1.502
1637985369,1637996400,11031,34.57,37.17,-2.6
1637500986,1637503200,2214,50.362,74.64,-24.278
1637500986,1637506800,5814,53.404,84.65,-31.246
1637500986,1637510400,9414,58.066,56.97,1.096
1637500986,1637514000,13014,63.52,85.32,-21.8
1637862543,1637863200,657,49.226,47.19,2.036
1637862543,1637866800,4257,49.244,45.05,4.194
1637862543,1637870400,7857,49.352,40.55,8.802
1637862543,1637874000,11457,47.192,36.39,10.802
1637367267,1637370000,2733,34.846,36.05,-1.204
1637367267,1637373600,6333,33.802,36.16,-2.358
1637367267,1637377200,9933,32.65,35.94,-3.29
1637367267,1637380800,13533,30.958,35.38,-4.422
1637627598,1637629200,1602,29.336,28.96,0.376
1637627598,1637632800,5202,27.824,28.17,-0.346
1637627598,1637636400,8802,25.736,27.84,-2.104
1637627598,1637640000,12402,23.234,27.95,-4.716
1637779381,1637780400,1019,61.038,58.89,2.148
1637779381,1637784000,4619,61.038,57.54,3.498
1637779381,1637787600,8219,59.742,52.7,7.042
1637779381,1637791200,11819,55.764,52.59,3.174
1637356404,1637359200,2796,39.79,39.76,0.03
1637356404,1637362800,6396,37.846,37.29,0.556
1637356404,1637366400,9996,35.452,35.38,0.072
1637356404,1637370000,13596,32.23,36.05,-3.82
1637963695,1637964000,305,42.476,41.79,0.686
1637963695,1637967600,3905,41.684,41.11,0.574
1637963695,1637971200,7505,40.406,41.56,-1.154
1637963695,1637974800,11105,38.876,39.76,-0.884
1637880610,1637881200,590,35.596,35.15,0.446
1637880610,1637884800,4190,34.75,35.6,-0.85
1637880610,1637888400,7790,33.706,35.71,-2.004
1637880610,1637892000,11390,32.626,33.69,-1.064
1637464865,1637467200,2335,46.094,45.84,0.254
1637464865,1637470800,5935,46.04,45.28,0.76
1637464865,1637474400,9535,46.742,45.72,1.022
1637464865,1637478000,13135,47.39,45.84,1.55
1637374495,1637377200,2705,36.316,35.94,0.376
1637374495,1637380800,6305,35.686,35.38,0.306
1637374495,1637384400,9905,34.858,37.17,-2.312
1637374495,1637388000,13505,34.084,37.74,-3.656
1637837247,1637838000,753,43.558,43.59,-0.032
1637837247,1637841600,4353,44.44,44.6,-0.16
1637837247,1637845200,7953,45.772,43.36,2.412
1637837247,1637848800,11553,49.786,56.3,-6.514
1637978145,1637978400,255,39.488,39.31,0.178
1637978145,1637982000,3855,38.588,37.85,0.738
1637978145,1637985600,7455,37.598,36.16,1.438
1637978145,1637989200,11055,36.392,36.72,-0.328
1637439577,1637442000,2423,46.812,45.84,0.972
1637439577,1637445600,6023,44.634,45.5,-0.866
1637439577,1637449200,9623,41.466,45.5,-4.034
1637439577,1637452800,13223,38.208,45.28,-7.072
1637475701,1637478000,2299,46.47,45.84,0.63
1637475701,1637481600,5899,47.334,46.06,1.274
1637475701,1637485200,9499,48.126,45.61,2.516
1637475701,1637488800,13099,48.63,43.59,5.04
1637797442,1637798400,958,52.23,53.26,-1.03
1637797442,1637802000,4558,51.78,52.36,-0.58
1637797442,1637805600,8158,51.132,51.46,-0.328
1637797442,1637809200,11758,50.394,51.01,-0.616
1638025105,1638025200,95,83.338,83.19,0.148
1638025105,1638028800,3695,84.382,81.5,2.882
1638025105,1638032400,7295,86.758,nan,nan
1638025105,1638036000,10895,90.196,nan,nan
1637743259,1637744400,1141,37.098,36.84,0.258
1637743259,1637748000,4741,37.584,35.83,1.754
1637743259,1637751600,8341,38.088,34.47,3.618
1637743259,1637755200,11941,38.628,39.31,-0.682
1637540781,1637542800,2019,37.042,36.05,0.992
1637540781,1637546400,5619,36.592,34.25,2.342
1637540781,1637550000,9219,36.412,33.01,3.402
1637540781,1637553600,12819,36.448,31.77,4.678
1637970920,1637971200,280,41.846,41.56,0.286
1637970920,1637974800,3880,40.964,39.76,1.204
1637970920,1637978400,7480,39.56,39.31,0.25
1637970920,1637982000,11080,38.246,37.85,0.396
1637634824,1637636400,1576,28.022,27.84,0.182
1637634824,1637640000,5176,26.726,27.95,-1.224
1637634824,1637643600,8776,25.16,27.5,-2.34
1637634824,1637647200,12376,23.234,27.39,-4.156
1637537169,1637539200,2031,38.916,37.96,0.956
1637537169,1637542800,5631,38.34,36.05,2.29
1637537169,1637546400,9231,37.44,34.25,3.19
1637537169,1637550000,12831,37.476,33.01,4.466
1637819121,1637820000,879,50.41,47.97,2.44
1637819121,1637823600,4479,50.572,45.05,5.522
1637819121,1637827200,8079,50.842,45.61,5.232
1637819121,1637830800,11679,51.706,45.61,6.096
1637457639,1637460000,2361,44.852,45.16,-0.308
1637457639,1637463600,5961,44.474,45.5,-1.026
1637457639,1637467200,9561,44.276,45.84,-1.564
1637457639,1637470800,13161,43.772,45.28,-1.508
1637671006,1637672400,1394,35.418,37.17,-1.752
1637671006,1637676000,4994,36.102,72.05,-35.948
1637671006,1637679600,8594,38.01,82.18,-44.17
1637671006,1637683200,12194,40.728,87.13,-46.402
1637631211,1637632800,1589,28.288,28.17,0.118
1637631211,1637636400,5189,26.866,27.84,-0.974
1637631211,1637640000,8789,24.976,27.95,-2.974
1637631211,1637643600,12389,22.888,27.5,-4.612
1637725199,1637726400,1201,34.722,35.15,-0.428
1637725199,1637730000,4801,34.794,35.38,-0.586
1637725199,1637733600,8401,34.758,37.63,-2.872
1637725199,1637737200,12001,34.74,37.63,-2.89
1637782993,1637784000,1007,-196.384,57.54,-253.924
1637782993,1637787600,4607,-197.266,52.7,-249.966
1637782993,1637791200,8207,-200.38,52.59,-252.97
1637782993,1637794800,11807,-203.71,52.25,-255.96
1637840860,1637841600,740,43.194,44.6,-1.406
1637840860,1637845200,4340,44.832,43.36,1.472
1637840860,1637848800,7940,48.396,56.3,-7.904
1637840860,1637852400,11540,54.354,68.11,-13.756
1637443190,1637445600,2410,45.018,45.5,-0.482
1637443190,1637449200,6010,42.732,45.5,-2.768
1637443190,1637452800,9610,40.068,45.28,-5.212
1637443190,1637456400,13210,37.8,44.94,-7.14
1637392557,1637395200,2643,39.018,37.29,1.728
1637392557,1637398800,6243,39.54,37.06,2.48
1637392557,1637402400,9843,39.864,36.28,3.584
1637392557,1637406000,13443,41.088,34.92,6.168
1637598697,1637600400,1703,83.842,81.84,2.002
1637598697,1637604000,5303,83.086,47.19,35.896
1637598697,1637607600,8903,81.682,42.35,39.332
1637598697,1637611200,12503,79.108,39.2,39.908
1637649333,1637650800,1467,27.324,27.39,-0.066
1637649333,1637654400,5067,26.532,27.5,-0.968
1637649333,1637658000,8667,25.56,26.83,-1.27
1637649333,1637661600,12267,24.588,26.38,-1.792
1637848090,1637848800,710,49.046,56.3,-7.254
1637848090,1637852400,4310,52.034,68.11,-16.076
1637848090,1637856000,7910,56.696,77.68,-20.984
1637848090,1637859600,11510,62.258,74.3,-12.042
1638021493,1638021600,107,71.494,72.16,-0.666
1638021493,1638025200,3707,72.952,83.19,-10.238
1638021493,1638028800,7307,75.85,81.5,-5.65
1638021493,1638032400,10907,80.044,nan,nan
1637385333,1637388000,2667,37.584,37.74,-0.156
1637385333,1637391600,6267,37.746,38.08,-0.334
1637385333,1637395200,9867,37.926,37.29,0.636
1637385333,1637398800,13467,38.034,37.06,0.974
1637775769,1637776800,1031,69.676,61.36,8.316
1637775769,1637780400,4631,70.216,58.89,11.326
1637775769,1637784000,8231,70.738,57.54,13.198
1637775769,1637787600,11831,69.388,52.7,16.688
1637750483,1637751600,1117,34.738,34.47,0.268
1637750483,1637755200,4717,35.458,39.31,-3.852
1637750483,1637758800,8317,37.546,47.75,-10.204
1637750483,1637762400,11917,42.568,-196.6,239.168
1637869773,1637870400,627,41.592,40.55,1.042
1637869773,1637874000,4227,40.458,36.39,4.068
1637869773,1637877600,7827,37.326,36.16,1.166
1637869773,1637881200,11427,35.148,35.15,-0.002
1637638436,1637640000,1564,27.484,27.95,-0.466
1637638436,1637643600,5164,26.386,27.5,-1.114
1637638436,1637647200,8764,24.964,27.39,-2.426
1637638436,1637650800,12364,23.128,27.39,-4.262
1637981757,1637982000,243,38.264,37.85,0.414
1637981757,1637985600,3843,37.238,36.16,1.078
1637981757,1637989200,7443,36.068,36.72,-0.652
1637981757,1637992800,11043,34.736,37.17,-2.434
1637757708,1637758800,1092,44.636,47.75,-3.114
1637757708,1637762400,4692,47.012,-196.6,243.612
1637757708,1637766000,8292,51.26,78.13,-26.87
1637757708,1637769600,11892,56.768,80.49,-23.722
1637305743,1637308800,3057,28.432,28.96,-0.528
1637305743,1637312400,6657,27.568,28.51,-0.942
1637305743,1637316000,10257,26.128,27.84,-1.712
1637305743,1637319600,13857,23.842,29.19,-5.348
1637577023,1637578800,1777,27.374,28.96,-1.586
1637577023,1637582400,5377,27.212,33.46,-6.248
1637577023,1637586000,8977,27.122,37.63,-10.508
1637577023,1637589600,12577,29.12,68.56,-39.44
1637345563,1637348400,2837,-195.664,46.17,-241.834
1637345563,1637352000,6437,-195.484,43.59,-239.074
1637345563,1637355600,10037,-196.204,41.0,-237.204
1637345563,1637359200,13637,-200.668,39.76,-240.428
1637580635,1637582400,1765,31.42,33.46,-2.04
1637580635,1637586000,5365,31.492,37.63,-6.138
1637580635,1637589600,8965,32.968,68.56,-35.592
1637580635,1637593200,12565,34.282,81.72,-47.438
1637291282,1637294400,3118,30.004,30.42,-0.416
1637291282,1637298000,6718,28.168,30.09,-1.922
1637291282,1637301600,10318,25.972,29.19,-3.218
1637291282,1637305200,13918,23.38,28.63,-5.25
1637526333,1637528400,2067,43.176,41.79,1.386
1637526333,1637532000,5667,41.718,40.33,1.388
1637526333,1637535600,9267,40.35,39.65,0.7
1637526333,1637539200,12867,39.072,37.96,1.112
1637522722,1637524800,2078,46.83,44.49,2.34
1637522722,1637528400,5678,46.038,41.79,4.248
1637522722,1637532000,9278,43.95,40.33,3.62
1637522722,1637535600,12878,42.222,39.65,2.572
1637934796,1637935200,404,54.394,56.3,-1.906
1637934796,1637938800,4004,53.332,70.14,-16.808
1637934796,1637942400,7604,52.738,75.76,-23.022
1637934796,1637946000,11204,52.108,74.07,-21.962
1637678232,1637679600,1368,79.612,82.18,-2.568
1637678232,1637683200,4968,80.26,87.13,-6.87
1637678232,1637686800,8568,81.61,82.18,-0.57
1637678232,1637690400,12168,83.212,52.47,30.742
1637435965,1637438400,2435,49.044,47.41,1.634
1637435965,1637442000,6035,48.684,45.84,2.844
1637435965,1637445600,9635,45.588,45.5,0.088
1637435965,1637449200,13235,41.862,45.5,-3.638
1637884222,1637884800,578,35.724,35.6,0.124
1637884222,1637888400,4178,34.734,35.71,-0.976
1637884222,1637892000,7778,33.582,33.69,-0.108
1637884222,1637895600,11378,31.998,31.55,0.448
1637493762,1637496000,2238,44.28,43.59,0.69
1637493762,1637499600,5838,46.152,48.31,-2.158
1637493762,1637503200,9438,49.806,74.64,-24.834
1637493762,1637506800,13038,54.702,84.65,-29.948
1637363632,1637366400,2768,36.318,35.38,0.938
1637363632,1637370000,6368,35.004,36.05,-1.046
1637363632,1637373600,9968,33.492,36.16,-2.668
1637363632,1637377200,13568,31.962,35.94,-3.978
1637999818,1638000000,182,34.446,34.36,0.086
1637999818,1638003600,3782,33.906,34.14,-0.234
1637999818,1638007200,7382,33.15,33.69,-0.54
1637999818,1638010800,10982,32.322,33.35,-1.028
1637790217,1637791200,983,50.284,52.59,-2.306
1637790217,1637794800,4583,48.718,52.25,-3.532
1637790217,1637798400,8183,46.576,53.26,-6.684
1637790217,1637802000,11783,43.93,52.36,-8.43
1637717974,1637719200,1226,37.666,37.4,0.266
1637717974,1637722800,4826,37.252,35.49,1.762
1637717974,1637726400,8426,36.64,35.15,1.49
1637717974,1637730000,12026,35.992,35.38,0.612
1638028718,1638028800,82,82.272,81.5,0.772
1638028718,1638032400,3682,83.442,nan,nan
1638028718,1638036000,7282,85.764,nan,nan
1638028718,1638039600,10882,88.914,nan,nan
1637414230,1637416800,2570,51.42,56.75,-5.33
1637414230,1637420400,6170,54.426,48.54,5.886
1637414230,1637424000,9770,58.548,50.67,7.878
1637414230,1637427600,13370,63.372,50.11,13.262
1637609534,1637611200,1666,40.244,39.2,1.044
1637609534,1637614800,5266,38.858,36.84,2.018
1637609534,1637618400,8866,36.284,33.24,3.044
1637609534,1637622000,12466,32.99,31.77,1.22
1637761320,1637762400,1080,66.38,-196.6,262.98
1637761320,1637766000,4680,68.936,78.13,-9.194
1637761320,1637769600,8280,72.914,80.49,-7.576
1637761320,1637773200,11880,77.792,85.44,-7.648
1637764932,1637766000,1068,87.278,78.13,9.148
1637764932,1637769600,4668,89.096,80.49,8.606
1637764932,1637773200,8268,91.994,85.44,6.554
1637764932,1637776800,11868,95.54,61.36,34.18
1637714362,1637715600,1238,36.298,36.72,-0.422
1637714362,1637719200,4838,35.542,37.4,-1.858
1637714362,1637722800,8438,34.606,35.49,-0.884
1637714362,1637726400,12038,33.49,35.15,-1.66
1637602310,1637604000,1690,78.242,47.19,31.052
1637602310,1637607600,5290,77.144,42.35,34.794
1637602310,1637611200,8890,75.074,39.2,35.874
1637602310,1637614800,12490,72.212,36.84,35.372
1637844476,1637845200,724,46.056,43.36,2.696
1637844476,1637848800,4324,48.288,56.3,-8.012
1637844476,1637852400,7924,52.77,68.11,-15.34
1637844476,1637856000,11524,58.674,77.68,-19.006
1637421516,1637424000,2484,53.496,50.67,2.826
1637421516,1637427600,6084,55.494,50.11,5.384
1637421516,1637431200,9684,58.032,49.55,8.482
1637421516,1637434800,13284,60.732,48.88,11.852
1637584247,1637586000,1753,35.386,37.63,-2.244
1637584247,1637589600,5353,36.286,68.56,-32.274
1637584247,1637593200,8953,37.546,81.72,-44.174
1637584247,1637596800,12553,38.482,84.99,-46.508
1637468477,1637470800,2323,46.184,45.28,0.904
1637468477,1637474400,5923,46.544,45.72,0.824
1637468477,1637478000,9523,46.958,45.84,1.118
1637468477,1637481600,13123,48.434,46.06,2.374
1637728811,1637730000,1189,34.79,35.38,-0.59
1637728811,1637733600,4789,34.934,37.63,-2.696
1637728811,1637737200,8389,35.06,37.63,-2.57
1637728811,1637740800,11989,35.204,35.94,-0.736
1637184736,1637186400,1664,60.24,56.97,3.27
1637184736,1637190000,5264,57.666,54.95,2.716
1637184736,1637193600,8864,54.57,51.46,3.11
1637184736,1637197200,12464,51.366,47.86,3.506
1637652945,1637654400,1455,28.542,27.5,1.042
1637652945,1637658000,5055,27.66,26.83,0.83
1637652945,1637661600,8655,26.742,26.38,0.362
1637652945,1637665200,12255,25.716,27.05,-1.334
1637551678,1637553600,1922,32.484,31.77,0.714
1637551678,1637557200,5522,31.926,31.44,0.486
1637551678,1637560800,9122,31.314,29.86,1.454
1637551678,1637564400,12722,31.674,30.76,0.914
1637490150,1637492400,2250,44.046,43.81,0.236
1637490150,1637496000,5850,44.514,43.59,0.924
1637490150,1637499600,9450,46.872,48.31,-1.438
1637490150,1637503200,13050,51.174,74.64,-23.466
1637562514,1637564400,1886,29.754,30.76,-1.006
1637562514,1637568000,5486,29.592,29.41,0.182
1637562514,1637571600,9086,29.988,29.08,0.908
1637562514,1637575200,12686,29.952,27.84,2.112
1637721586,1637722800,1214,36.694,35.49,1.204
1637721586,1637726400,4814,36.514,35.15,1.364
1637721586,1637730000,8414,36.226,35.38,0.846
1637721586,1637733600,12014,35.848,37.63,-1.782
1637923959,1637924400,441,25.878,25.81,0.068
1637923959,1637928000,4041,24.348,28.85,-4.502
1637923959,1637931600,7641,22.602,32.34,-9.738
1637923959,1637935200,11241,21.054,56.3,-35.246
1637736035,1637737200,1165,37.614,37.63,-0.016
1637736035,1637740800,4765,38.082,35.94,2.142
1637736035,1637744400,8365,38.478,36.84,1.638
1637736035,1637748000,11965,38.838,35.83,3.008
1637159341,1637161200,1859,93.6,90.39,3.21
1637159341,1637164800,5459,98.1,100.4,-2.3
1637159341,1637168400,9059,103.662,98.04,5.622
1637159341,1637172000,12659,109.224,66.65,42.574
1637454027,1637456400,2373,45.118,44.94,0.178
1637454027,1637460000,5973,44.11,45.16,-1.05
1637454027,1637463600,9573,43.012,45.5,-2.488
1637454027,1637467200,13173,42.22,45.84,-3.62
1637696294,1637697600,1306,48.198,46.96,1.238
1637696294,1637701200,4906,47.532,42.13,5.402
1637696294,1637704800,8506,44.868,38.3,6.568
1637696294,1637708400,12106,41.016,36.61,4.406
1637754095,1637755200,1105,37.452,39.31,-1.858
1637754095,1637758800,4705,39.036,47.75,-8.714
1637754095,1637762400,8305,43.032,-196.6,239.632
1637754095,1637766000,11905,48.612,78.13,-29.518
1637811894,1637812800,906,51.62,50.22,1.4
1637811894,1637816400,4506,51.89,49.21,2.68
1637811894,1637820000,8106,52.106,47.97,4.136
1637811894,1637823600,11706,52.628,45.05,7.578
1637381721,1637384400,2679,36.482,37.17,-0.688
1637381721,1637388000,6279,36.5,37.74,-1.24
1637381721,1637391600,9879,36.41,38.08,-1.67
1637381721,1637395200,13479,36.392,37.29,-0.898
1637591472,1637593200,1728,73.49,81.72,-8.23
1637591472,1637596800,5328,73.778,84.99,-11.212
1637591472,1637600400,8928,74.444,81.84,-7.396
1637591472,1637604000,12528,74.228,47.19,27.038
1637931184,1637931600,416,32.756,32.34,0.416
1637931184,1637935200,4016,31.46,56.3,-24.84
1637931184,1637938800,7616,30.02,70.14,-40.12
1637931184,1637942400,11216,29.372,75.76,-46.388
1637945632,1637946000,368,77.454,74.07,3.384
1637945632,1637949600,3968,76.752,48.2,28.552
1637945632,1637953200,7568,75.87,44.49,31.38
1637945632,1637956800,11168,74.358,43.36,30.998
1637952857,1637953200,343,44.976,44.49,0.486
1637952857,1637956800,3943,44.454,43.36,1.094
1637952857,1637960400,7543,43.068,42.58,0.488
1637952857,1637964000,11143,40.242,41.79,-1.548
1637312975,1637316000,3025,27.948,27.84,0.108
1637312975,1637319600,6625,26.436,29.19,-2.754
1637312975,1637323200,10225,24.258,34.47,-10.212
1637312975,1637326800,13825,23.34,39.54,-16.2
1637316589,1637319600,3011,27.064,29.19,-2.126
1637316589,1637323200,6611,25.336,34.47,-9.134
1637316589,1637326800,10211,24.364,39.54,-15.176
1637316589,1637330400,13811,25.012,47.75,-22.738
1637866158,1637866800,642,45.446,45.05,0.396
1637866158,1637870400,4242,45.122,40.55,4.572
1637866158,1637874000,7842,43.322,36.39,6.932
1637866158,1637877600,11442,39.272,36.16,3.112
1637905896,1637906400,504,28.888,28.51,0.378
1637905896,1637910000,4104,27.898,27.5,0.398
1637905896,1637913600,7704,26.8,27.05,-0.25
1637905896,1637917200,11304,25.324,26.38,-1.056
1637707130,1637708400,1270,36.536,36.61,-0.074
1637707130,1637712000,4870,35.168,35.49,-0.322
1637707130,1637715600,8470,33.404,36.72,-3.316
1637707130,1637719200,12070,31.478,37.4,-5.922
1637349177,1637352000,2823,48.488,43.59,4.898
1637349177,1637355600,6423,47.93,41.0,6.93
1637349177,1637359200,10023,44.438,39.76,4.678
1637349177,1637362800,13623,41.378,37.29,4.088
1637309360,1637312400,3040,28.294,28.51,-0.216
1637309360,1637316000,6640,27.142,27.84,-0.698
1637309360,1637319600,10240,25.234,29.19,-3.956
1637309360,1637323200,13840,22.66,34.47,-11.81
1637515436,1637517600,2164,75.542,54.28,21.262
1637515436,1637521200,5764,76.334,47.41,28.924
1637515436,1637524800,9364,76.1,44.49,31.61
1637515436,1637528400,12964,74.606,41.79,32.816
