time_measured,estimation_time,time_diff_seconds,predicted_temp_f,actual_temp_f,diff_f
1637887835,1637888400,565,31.336,35.71,-4.374
1637887835,1637892000,4165,30.472,33.69,-3.218
1637887835,1637895600,7765,29.248,31.55,-2.302
1637887835,1637899200,11365,27.322,29.75,-2.428
1637410617,1637413200,2583,39.364,48.42,-9.056
1637410617,1637416800,6183,42.82,56.75,-13.93
1637410617,1637420400,9783,47.086,48.54,-1.454
1637410617,1637424000,13383,52.432,50.67,1.762
1637833575,1637834400,825,44.08,44.15,-0.07
1637833575,1637838000,4425,44.98,43.59,1.39
1637833575,1637841600,8025,46.096,44.6,1.496
1637833575,1637845200,11625,47.77,43.36,4.41
1637956469,1637956800,331,42.602,43.36,-0.758
1637956469,1637960400,3931,42.008,42.58,-0.572
1637956469,1637964000,7531,40.172,41.79,-1.618
1637956469,1637967600,11131,38.084,41.11,-3.026
1637938408,1637938800,392,39.258,70.14,-30.882
1637938408,1637942400,3992,38.574,75.76,-37.186
1637938408,1637946000,7592,38.16,74.07,-35.91
1637938408,1637949600,11192,37.656,48.2,-10.544
1637173826,1637175600,1774,67.66,64.85,2.81
1637173826,1637179200,5374,67.516,62.6,4.916
1637173826,1637182800,8974,65.608,61.14,4.468
1637173826,1637186400,12574,60.64,56.97,3.67
1637320203,1637323200,2997,22.136,34.47,-12.334
1637320203,1637326800,6597,21.164,39.54,-18.376
1637320203,1637330400,10197,21.488,47.75,-26.262
1637320203,1637334000,13797,22.964,46.96,-23.996
1637352791,1637355600,2809,42.332,41.0,1.332
1637352791,1637359200,6409,39.956,39.76,0.196
1637352791,1637362800,10009,37.382,37.29,0.092
1637352791,1637366400,13609,34.502,35.38,-0.878
1637703517,1637704800,1283,35.562,38.3,-2.738
1637703517,1637708400,4883,33.978,36.61,-2.632
1637703517,1637712000,8483,31.764,35.49,-3.726
1637703517,1637715600,12083,29.28,36.72,-7.44
1637793830,1637794800,970,54.55,52.25,2.3
1637793830,1637798400,4570,53.614,53.26,0.354
1637793830,1637802000,8170,52.174,52.36,-0.186
1637793830,1637805600,11770,50.698,51.46,-0.762
1637181076,1637182800,1724,64.06,61.14,2.92
1637181076,1637186400,5324,61.684,56.97,4.714
1637181076,1637190000,8924,58.138,54.95,3.188
1637181076,1637193600,12524,54.412,51.46,2.952
1637642049,1637643600,1551,20.912,27.5,-6.588
1637642049,1637647200,5151,19.958,27.39,-7.432
1637642049,1637650800,8751,18.626,27.39,-8.764
1637642049,1637654400,12351,16.826,27.5,-10.674
1637461252,1637463600,2348,46.078,45.5,0.578
1637461252,1637467200,5948,46.06,45.84,0.22
1637461252,1637470800,9548,45.808,45.28,0.528
1637461252,1637474400,13148,46.6,45.72,0.88
1638010656,1638010800,144,30.43,33.35,-2.92
1638010656,1638014400,3744,30.178,36.95,-6.772
1638010656,1638018000,7344,30.934,43.59,-12.656
1638010656,1638021600,10944,34.264,72.16,-37.896
1637294901,1637298000,3099,23.252,30.09,-6.838
1637294901,1637301600,6699,21.938,29.19,-7.252
1637294901,1637305200,10299,20.174,28.63,-8.456
1637294901,1637308800,13899,18.194,28.96,-10.766
1637338274,1637341200,2926,42.962,60.57,-17.608
1637338274,1637344800,6526,43.916,48.99,-5.074
1637338274,1637348400,10126,45.068,46.17,-1.102
1637338274,1637352000,13726,45.716,43.59,2.126
1637942020,1637942400,380,45.446,75.76,-30.314
1637942020,1637946000,3980,44.762,74.07,-29.308
1637942020,1637949600,7580,44.114,48.2,-4.086
1637942020,1637953200,11180,43.142,44.49,-1.348
1637407004,1637409600,2596,31.624,41.11,-9.486
1637407004,1637413200,6196,33.424,48.42,-14.996
1637407004,1637416800,9796,37.942,56.75,-18.808
1637407004,1637420400,13396,42.91,48.54,-5.63
1637166583,1637168400,1817,72.286,98.04,-25.754
1637166583,1637172000,5417,74.392,66.65,7.742
1637166583,1637175600,9017,76.552,64.85,11.702
1637166583,1637179200,12617,77.83,62.6,15.23
1637450414,1637452800,2386,45.252,45.28,-0.028
1637450414,1637456400,5986,44.01,44.94,-0.93
1637450414,1637460000,9586,42.3,45.16,-2.86
1637450414,1637463600,13186,40.608,45.5,-4.892
1637486538,1637488800,2262,43.806,43.59,0.216
1637486538,1637492400,5862,44.022,43.81,0.212
1637486538,1637496000,9462,44.634,43.59,1.044
1637486538,1637499600,13062,47.676,48.31,-0.634
1637732423,1637733600,1177,34.232,37.63,-3.398
1637732423,1637737200,4777,34.412,37.63,-3.218
1637732423,1637740800,8377,34.61,35.94,-1.33
1637732423,1637744400,11977,34.7,36.84,-2.14
1637472090,1637474400,2310,46.438,45.72,0.718
1637472090,1637478000,5910,46.942,45.84,1.102
1637472090,1637481600,9510,48.31,46.06,2.25
1637472090,1637485200,13110,49.336,45.61,3.726
1637801054,1637802000,946,54.662,52.36,2.302
1637801054,1637805600,4546,54.626,51.46,3.166
1637801054,1637809200,8146,54.482,51.01,3.472
1637801054,1637812800,11746,54.356,50.22,4.136
1637674619,1637676000,1381,49.762,72.05,-22.288
1637674619,1637679600,4981,50.446,82.18,-31.734
1637674619,1637683200,8581,52.084,87.13,-35.046
1637674619,1637686800,12181,54.298,82.18,-27.882
1637992594,1637992800,206,34.072,37.17,-3.098
1637992594,1637996400,3806,33.658,37.17,-3.512
1637992594,1638000000,7406,33.046,34.36,-1.314
1637992594,1638003600,11006,32.38,34.14,-1.76
1637829960,1637830800,840,47.174,45.61,1.564
1637829960,1637834400,4440,47.606,44.15,3.456
1637829960,1637838000,8040,49.01,43.59,5.42
1637829960,1637841600,11640,50.234,44.6,5.634
1637555290,1637557200,1910,29.676,31.44,-1.764
1637555290,1637560800,5510,29.262,29.86,-0.598
1637555290,1637564400,9110,29.55,30.76,-1.21
1637555290,1637568000,12710,29.856,29.41,0.446
1637620372,1637622000,1628,26.062,31.77,-5.708
1637620372,1637625600,5228,24.712,29.86,-5.148
1637620372,1637629200,8828,22.93,28.96,-6.03
1637620372,1637632800,12428,20.14,28.17,-8.03
1637569799,1637571600,1801,25.376,29.08,-3.704
1637569799,1637575200,5401,25.34,27.84,-2.5
1637569799,1637578800,9001,25.394,28.96,-3.566
1637569799,1637582400,12601,24.26,33.46,-9.2
1637876998,1637877600,602,31.334,36.16,-4.826
1637876998,1637881200,4202,30.146,35.15,-5.004
1637876998,1637884800,7802,28.634,35.6,-6.966
1637876998,1637888400,11402,26.978,35.71,-8.732
1637685456,1637686800,1344,48.382,82.18,-33.798
1637685456,1637690400,4944,48.85,52.47,-3.62
1637685456,1637694000,8544,49.318,50.22,-0.902
1637685456,1637697600,12144,49.66,46.96,2.7
1637858930,1637859600,670,41.81,74.3,-32.49
1637858930,1637863200,4270,42.296,47.19,-4.894
1637858930,1637866800,7870,43.538,45.05,-1.512
1637858930,1637870400,11470,44.438,40.55,3.888
1638017881,1638018000,119,55.92,43.59,12.33
1638017881,1638021600,3719,57.36,72.16,-14.8
1638017881,1638025200,7319,60.42,83.19,-22.77
1638017881,1638028800,10919,64.866,81.5,-16.634
1637913121,1637913600,479,19.062,27.05,-7.988
1637913121,1637917200,4079,18.36,26.38,-8.02
1637913121,1637920800,7679,16.578,26.6,-10.022
1637913121,1637924400,11279,14.598,25.81,-11.212
1637323817,1637326800,2983,28.162,39.54,-11.378
1637323817,1637330400,6583,28.27,47.75,-19.48
1637323817,1637334000,10183,29.566,46.96,-17.394
1637323817,1637337600,13783,31.708,48.09,-16.382
1637533558,1637535600,2042,38.496,39.65,-1.154
1637533558,1637539200,5642,37.848,37.96,-0.112
1637533558,1637542800,9242,37.074,36.05,1.024
1637533558,1637546400,12842,35.904,34.25,1.654
1637739646,1637740800,1154,35.206,35.94,-0.734
1637739646,1637744400,4754,35.692,36.84,-1.148
1637739646,1637748000,8354,36.124,35.83,0.294
1637739646,1637751600,11954,36.61,34.47,2.14
1637855317,1637856000,683,48.792,77.68,-28.888
1637855317,1637859600,4283,49.872,74.3,-24.428
1637855317,1637863200,7883,51.852,47.19,4.662
1637855317,1637866800,11483,54.498,45.05,9.448
1638003431,1638003600,169,33.116,34.14,-1.024
1638003431,1638007200,3769,32.684,33.69,-1.006
1638003431,1638010800,7369,32.108,33.35,-1.242
1638003431,1638014400,10969,31.46,36.95,-5.49
1637573411,1637575200,1789,24.06,27.84,-3.78
1637573411,1637578800,5389,24.096,28.96,-4.864
1637573411,1637582400,8989,23.556,33.46,-9.904
1637573411,1637586000,12589,23.412,37.63,-14.218
1637927571,1637928000,429,21.364,28.85,-7.486
1637927571,1637931600,4029,20.05,32.34,-12.29
1637927571,1637935200,7629,18.79,56.3,-37.51
1637927571,1637938800,11229,17.278,70.14,-52.862
1637519049,1637521200,2151,47.48,47.41,0.07
1637519049,1637524800,5751,47.39,44.49,2.9
1637519049,1637528400,9351,46.184,41.79,4.394
1637519049,1637532000,12951,43.538,40.33,3.208
1637544393,1637546400,2007,33.402,34.25,-0.848
1637544393,1637550000,5607,33.312,33.01,0.302
1637544393,1637553600,9207,33.42,31.77,1.65
1637544393,1637557200,12807,32.736,31.44,1.296
1637804667,1637805600,933,53.44,51.46,1.98
1637804667,1637809200,4533,53.566,51.01,2.556
1637804667,1637812800,8133,53.692,50.22,3.472
1637804667,1637816400,11733,53.998,49.21,4.788
1637681844,1637683200,1356,55.078,87.13,-32.052
1637681844,1637686800,4956,55.726,82.18,-26.454
1637681844,1637690400,8556,56.77,52.47,4.3
1637681844,1637694000,12156,57.616,50.22,7.396
1637425128,1637427600,2472,48.682,50.11,-1.428
1637425128,1637431200,6072,50.248,49.55,0.698
1637425128,1637434800,9672,52.12,48.88,3.24
1637425128,1637438400,13272,53.38,47.41,5.97
1637170203,1637172000,1797,70.248,66.65,3.598
1637170203,1637175600,5397,71.04,64.85,6.19
1637170203,1637179200,8997,71.238,62.6,8.638
1637170203,1637182800,12597,68.646,61.14,7.506
1637974533,1637974800,267,38.782,39.76,-0.978
1637974533,1637978400,3867,37.648,39.31,-1.662
1637974533,1637982000,7467,36.388,37.85,-1.462
1637974533,1637985600,11067,35.02,36.16,-1.14
1637334660,1637337600,2940,40.514,48.09,-7.576
1637334660,1637341200,6540,41.432,60.57,-19.138
1637334660,1637344800,10140,42.89,48.99,-6.1
1637334660,1637348400,13740,44.42,46.17,-1.75
1637428740,1637431200,2460,50.018,49.55,0.468
1637428740,1637434800,6060,51.17,48.88,2.29
1637428740,1637438400,9660,51.998,47.41,4.588
1637428740,1637442000,13260,51.53,45.84,5.69
1637548006,1637550000,1994,30.564,33.01,-2.446
1637548006,1637553600,5594,30.438,31.77,-1.332
1637548006,1637557200,9194,29.79,31.44,-1.65
1637548006,1637560800,12794,29.178,29.86,-0.682
1637692680,1637694000,1320,52.072,50.22,1.852
1637692680,1637697600,4920,51.838,46.96,4.878
1637692680,1637701200,8520,50.83,42.13,8.7
1637692680,1637704800,12120,47.212,38.3,8.912
1637815509,1637816400,891,50.162,49.21,0.952
1637815509,1637820000,4491,50.234,47.97,2.264
1637815509,1637823600,8091,50.504,45.05,5.454
1637815509,1637827200,11691,50.792,45.61,5.182
1637826346,1637827200,854,48.178,45.61,2.568
1637826346,1637830800,4454,48.61,45.61,3.0
1637826346,1637834400,8054,48.952,44.15,4.802
1637826346,1637838000,11654,50.788,43.59,7.198
1637595084,1637596800,1716,41.11,84.99,-43.88
1637595084,1637600400,5316,41.092,81.84,-40.748
1637595084,1637604000,8916,40.606,47.19,-6.584
1637595084,1637607600,12516,39.364,42.35,-2.986
1637613147,1637614800,1653,34.556,36.84,-2.284
1637613147,1637618400,5253,33.098,33.24,-0.142
1637613147,1637622000,8853,30.776,31.77,-0.994
1637613147,1637625600,12453,28.166,29.86,-1.694
1637529946,1637532000,2054,39.43,40.33,-0.9
1637529946,1637535600,5654,38.44,39.65,-1.21
1637529946,1637539200,9254,37.414,37.96,-0.546
1637529946,1637542800,12854,36.244,36.05,0.194
1637768545,1637769600,1055,62.694,80.49,-17.796
1637768545,1637773200,4655,64.116,85.44,-21.324
1637768545,1637776800,8255,66.312,61.36,4.952
1637768545,1637780400,11855,68.886,58.89,9.996
1637566127,1637568000,1873,27.534,29.41,-1.876
1637566127,1637571600,5473,27.696,29.08,-1.384
1637566127,1637575200,9073,27.642,27.84,-0.198
1637566127,1637578800,12673,27.696,28.96,-1.264
1637988981,1637989200,219,33.69,36.72,-3.03
1637988981,1637992800,3819,32.952,37.17,-4.218
1637988981,1637996400,7419,32.178,37.17,-4.992
1637988981,1638000000,11019,30.792,34.36,-3.568
1637699906,1637701200,1294,42.586,42.13,0.456
1637699906,1637704800,4894,41.218,38.3,2.918
1637699906,1637708400,8494,38.392,36.61,1.782
1637699906,1637712000,12094,35.332,35.49,-0.158
1637399781,1637402400,2619,35.89,36.28,-0.39
1637399781,1637406000,6219,36.988,34.92,2.068
1637399781,1637409600,9819,37.564,41.11,-3.546
1637399781,1637413200,13419,40.264,48.42,-8.156
1637341889,1637344800,2911,48.452,48.99,-0.538
1637341889,1637348400,6511,49.118,46.17,2.948
1637341889,1637352000,10111,49.496,43.59,5.906
1637341889,1637355600,13711,48.596,41.0,7.596
1637898671,1637899200,529,23.976,29.75,-5.774
1637898671,1637902800,4129,22.878,28.74,-5.862
1637898671,1637906400,7729,21.204,28.51,-7.306
1637898671,1637910000,11329,19.296,27.5,-8.204
1637497374,1637499600,2226,43.936,48.31,-4.374
1637497374,1637503200,5826,46.87,74.64,-27.77
1637497374,1637506800,9426,51.1,84.65,-33.55
1637497374,1637510400,13026,57.022,56.97,0.052
1637479314,1637481600,2286,45.46,46.06,-0.6
1637479314,1637485200,5886,45.892,45.61,0.282
1637479314,1637488800,9486,46.162,43.59,2.572
1637479314,1637492400,13086,46.09,43.81,2.28
1637663782,1637665200,1418,20.68,27.05,-6.37
1637663782,1637668800,5018,19.978,30.99,-11.012
1637663782,1637672400,8618,20.482,37.17,-16.688
1637663782,1637676000,12218,23.092,72.05,-48.958
1637746870,1637748000,1130,33.548,35.83,-2.282
1637746870,1637751600,4730,34.052,34.47,-0.418
1637746870,1637755200,8330,34.574,39.31,-4.736
1637746870,1637758800,11930,37.148,47.75,-10.602
1637587860,1637589600,1740,41.646,68.56,-26.914
1637587860,1637593200,5340,42.636,81.72,-39.084
1637587860,1637596800,8940,43.518,84.99,-41.472
1637587860,1637600400,12540,44.256,81.84,-37.584
1637822734,1637823600,866,44.582,45.05,-0.468
1637822734,1637827200,4466,44.906,45.61,-0.704
1637822734,1637830800,8066,45.644,45.61,0.034
1637822734,1637834400,11666,46.04,44.15,1.89
1637645661,1637647200,1539,21.682,27.39,-5.708
1637645661,1637650800,5139,20.908,27.39,-6.482
1637645661,1637654400,8739,19.684,27.5,-7.816
1637645661,1637658000,12339,18.262,26.83,-8.568
1637177446,1637179200,1754,65.75,62.6,3.15
1637177446,1637182800,5354,64.49,61.14,3.35
1637177446,1637186400,8954,60.62,56.97,3.65
1637177446,1637190000,12554,56.282,54.95,1.332
1637388945,1637391600,2655,36.46,38.08,-1.62
1637388945,1637395200,6255,36.838,37.29,-0.452
1637388945,1637398800,9855,37.27,37.06,0.21
1637388945,1637402400,13455,37.414,36.28,1.134
1637667394,1637668800,1406,24.332,30.99,-6.658
1637667394,1637672400,5006,24.17,37.17,-13.0
1637667394,1637676000,8606,25.826,72.05,-46.224
1637667394,1637679600,12206,28.4,82.18,-53.78
1637967308,1637967600,292,39.108,41.11,-2.002
1637967308,1637971200,3892,38.334,41.56,-3.226
1637967308,1637974800,7492,37.218,39.76,-2.542
1637967308,1637978400,11092,35.724,39.31,-3.586
1637660169,1637661600,1431,20.278,26.38,-6.102
1637660169,1637665200,5031,19.738,27.05,-7.312
1637660169,1637668800,8631,19.108,30.99,-11.882
1637660169,1637672400,12231,20.314,37.17,-16.856
1637508211,1637510400,2189,52.272,56.97,-4.698
1637508211,1637514000,5789,54.774,85.32,-30.546
1637508211,1637517600,9389,56.556,54.28,2.276
1637508211,1637521200,12989,58.086,47.41,10.676
1637403393,1637406000,2607,34.768,34.92,-0.152
1637403393,1637409600,6207,35.488,41.11,-5.622
1637403393,1637413200,9807,37.774,48.42,-10.646
1637403393,1637416800,13407,43.39,56.75,-13.36
1637378109,1637380800,2691,34.648,35.38,-0.732
1637378109,1637384400,6291,34.306,37.17,-2.864
1637378109,1637388000,9891,33.928,37.74,-3.812
1637378109,1637391600,13491,33.442,38.08,-4.638
1637960082,1637960400,318,40.964,42.58,-1.616
1637960082,1637964000,3918,39.812,41.79,-1.978
1637960082,1637967600,7518,38.084,41.11,-3.026
1637960082,1637971200,11118,35.924,41.56,-5.636
1637511824,1637514000,2176,52.808,85.32,-32.512
1637511824,1637517600,5776,54.104,54.28,-0.176
1637511824,1637521200,9376,55.166,47.41,7.756
1637511824,1637524800,12976,54.932,44.49,10.442
1637360017,1637362800,2783,36.342,37.29,-0.948
1637360017,1637366400,6383,34.776,35.38,-0.604
1637360017,1637370000,9983,32.436,36.05,-3.614
1637360017,1637373600,13583,30.078,36.16,-6.082
1637331045,1637334000,2955,39.234,46.96,-7.726
1637331045,1637337600,6555,40.098,48.09,-7.992
1637331045,1637341200,10155,41.736,60.57,-18.834
1637331045,1637344800,13755,43.788,48.99,-5.202
1638014268,1638014400,132,34.086,36.95,-2.864
1638014268,1638018000,3732,34.41,43.59,-9.18
1638014268,1638021600,7332,36.786,72.16,-35.374
1638014268,1638025200,10932,40.602,83.19,-42.588
1637895060,1637895600,540,27.106,31.55,-4.444
1637895060,1637899200,4140,26.008,29.75,-3.742
1637895060,1637902800,7740,24.586,28.74,-4.154
1637895060,1637906400,11340,22.498,28.51,-6.012
1637396169,1637398800,2631,36.18,37.06,-0.88
1637396169,1637402400,6231,36.612,36.28,0.332
1637396169,1637406000,9831,37.674,34.92,2.754
1637396169,1637409600,13431,37.89,41.11,-3.22
1637873386,1637874000,614,32.308,36.39,-4.082
1637873386,1637877600,4214,30.544,36.16,-5.616
1637873386,1637881200,7814,28.762,35.15,-6.388
1637873386,1637884800,11414,26.512,35.6,-9.088
1637916734,1637917200,466,19.486,26.38,-6.894
1637916734,1637920800,4066,18.46,26.6,-8.14
1637916734,1637924400,7666,16.948,25.81,-8.862
1637916734,1637928000,11266,13.528,28.85,-15.322
1637298515,1637301600,3085,22.55,29.19,-6.64
1637298515,1637305200,6685,21.344,28.63,-7.286
1637298515,1637308800,10285,19.85,28.96,-9.11
1637298515,1637312400,13885,17.96,28.51,-10.55
1637504599,1637506800,2201,57.576,84.65,-27.074
1637504599,1637510400,5801,60.78,56.97,3.81
1637504599,1637514000,9401,64.956,85.32,-20.364
1637504599,1637517600,13001,67.782,54.28,13.502
1637786605,1637787600,995,57.708,52.7,5.008
1637786605,1637791200,4595,55.836,52.59,3.246
1637786605,1637794800,8195,53.064,52.25,0.814
1637786605,1637798400,11795,49.842,53.26,-3.418
1637902284,1637902800,516,22.442,28.74,-6.298
1637902284,1637906400,4116,21.308,28.51,-7.202
1637902284,1637910000,7716,19.814,27.5,-7.686
1637902284,1637913600,11316,18.482,27.05,-8.568
1637808280,1637809200,920,53.028,51.01,2.018
1637808280,1637812800,4520,52.974,50.22,2.754
1637808280,1637816400,8120,53.046,49.21,3.836
1637808280,1637820000,11720,52.992,47.97,5.022
1638007044,1638007200,156,30.94,33.69,-2.75
1638007044,1638010800,3756,30.436,33.35,-2.914
1638007044,1638014400,7356,29.842,36.95,-7.108
1638007044,1638018000,10956,30.832,43.59,-12.758
1637432353,1637434800,2447,49.298,48.88,0.418
1637432353,1637438400,6047,49.73,47.41,2.32
1637432353,1637442000,9647,49.154,45.84,3.314
1637432353,1637445600,13247,45.212,45.5,-0.288
1637162962,1637164800,1838,70.9,100.4,-29.5
1637162962,1637168400,5438,74.032,98.04,-24.008
1637162962,1637172000,9038,77.47,66.65,10.82
1637162962,1637175600,12638,80.782,64.85,15.932
1637996206,1637996400,194,34.482,37.17,-2.688
1637996206,1638000000,3794,33.978,34.36,-0.382
1637996206,1638003600,7394,33.366,34.14,-0.774
1637996206,1638007200,10994,32.484,33.69,-1.206
1637851704,1637852400,696,44.782,68.11,-23.328
1637851704,1637856000,4296,46.636,77.68,-31.044
1637851704,1637859600,7896,49.642,74.3,-24.658
1637851704,1637863200,11496,53.404,47.19,6.214
1637710750,1637712000,1250,31.894,35.49,-3.596
1637710750,1637715600,4850,30.67,36.72,-6.05
1637710750,1637719200,8450,29.194,37.4,-8.206
1637710750,1637722800,12050,27.592,35.49,-7.898
1637891447,1637892000,553,29.786,33.69,-3.904
1637891447,1637895600,4153,28.85,31.55,-2.7
1637891447,1637899200,7753,27.338,29.75,-2.412
1637891447,1637902800,11353,25.646,28.74,-3.094
1637370881,1637373600,2719,35.026,36.16,-1.134
1637370881,1637377200,6319,34.324,35.94,-1.616
1637370881,1637380800,9919,32.992,35.38,-2.388
1637370881,1637384400,13519,31.552,37.17,-5.618
1637909508,1637910000,492,20.734,27.5,-6.766
1637909508,1637913600,4092,19.744,27.05,-7.306
1637909508,1637917200,7692,18.466,26.38,-7.914
1637909508,1637920800,11292,15.694,26.6,-10.906
1637302130,1637305200,3070,21.814,28.63,-6.816
1637302130,1637308800,6670,20.896,28.96,-8.064
1637302130,1637312400,10270,19.528,28.51,-8.982
1637302130,1637316000,13870,17.53,27.84,-10.31
1637949245,1637949600,355,54.39,48.2,6.19
1637949245,1637953200,3955,53.814,44.49,9.324
1637949245,1637956800,7555,52.788,43.36,9.428
1637949245,1637960400,11155,50.682,42.58,8.102
1637482925,1637485200,2275,46.054,45.61,0.444
1637482925,1637488800,5875,46.18,43.59,2.59
1637482925,1637492400,9475,46.054,43.81,2.244
1637482925,1637496000,13075,45.748,43.59,2.158
1637772157,1637773200,1043,62.328,85.44,-23.112
1637772157,1637776800,4643,63.228,61.36,1.868
1637772157,1637780400,8243,64.65,58.89,5.76
1637772157,1637784000,11843,65.766,57.54,8.226
1637605922,1637607600,1678,41.484,42.35,-0.866
1637605922,1637611200,5278,39.954,39.2,0.754
1637605922,1637614800,8878,37.596,36.84,0.756
1637605922,1637618400,12478,33.834,33.24,0.594
1637616759,1637618400,1641,30.85,33.24,-2.39
1637616759,1637622000,5241,29.266,31.77,-2.504
1637616759,1637625600,8841,27.232,29.86,-2.628
1637616759,1637629200,12441,24.784,28.96,-4.176
1637327431,1637330400,2969,35.686,47.75,-12.064
1637327431,1637334000,6569,36.298,46.96,-10.662
1637327431,1637337600,10169,37.828,48.09,-10.262
1637327431,1637341200,13769,40.042,60.57,-20.528
1637656557,1637658000,1443,20.822,26.83,-6.008
1637656557,1637661600,5043,20.066,26.38,-6.314
1637656557,1637665200,8643,19.22,27.05,-7.83
1637656557,1637668800,12243,18.266,30.99,-12.724
1637920347,1637920800,453,18.75,26.6,-7.85
1637920347,1637924400,4053,17.4,25.81,-8.41
1637920347,1637928000,7653,14.61,28.85,-14.24
1637920347,1637931600,11253,12.216,32.34,-20.124
1637417903,1637420400,2497,49.19,48.54,0.65
1637417903,1637424000,6097,51.71,50.67,1.04
1637417903,1637427600,9697,55.058,50.11,4.948
1637417903,1637431200,13297,58.802,49.55,9.252
1637558902,1637560800,1898,26.656,29.86,-3.204
1637558902,1637564400,5498,26.728,30.76,-4.032
1637558902,1637568000,9098,26.926,29.41,-2.484
1637558902,1637571600,12698,27.07,29.08,-2.01
1637623985,1637625600,1615,24.924,29.86,-4.936
1637623985,1637629200,5215,23.664,28.96,-5.296
1637623985,1637632800,8815,21.576,28.17,-6.594
1637623985,1637636400,12415,18.93,27.84,-8.91
1637446803,1637449200,2397,45.64,45.5,0.14
1637446803,1637452800,5997,43.84,45.28,-1.44
1637446803,1637456400,9597,42.004,44.94,-2.936
1637446803,1637460000,13197,39.628,45.16,-5.532
1637985369,1637985600,231,34.588,36.16,-1.572
1637985369,1637989200,3831,33.616,36.72,-3.104
1637985369,1637992800,7431,32.518,37.17,-4.652
1637985369,1637996400,11031,31.42,37.17,-5.75
1637500986,1637503200,2214,49.352,74.64,-25.288
1637500986,1637506800,5814,52.394,84.65,-32.256
1637500986,1637510400,9414,57.056,56.97,0.086
1637500986,1637514000,13014,62.51,85.32,-22.81
1637862543,1637863200,657,39.556,47.19,-7.634
1637862543,1637866800,4257,39.574,45.05,-5.476
1637862543,1637870400,7857,39.682,40.55,-0.868
1637862543,1637874000,11457,37.522,36.39,1.132
1637367267,1637370000,2733,33.946,36.05,-2.104
1637367267,1637373600,6333,32.902,36.16,-3.258
1637367267,1637377200,9933,31.75,35.94,-4.19
1637367267,1637380800,13533,30.058,35.38,-5.322
1637627598,1637629200,1602,23.266,28.96,-5.694
1637627598,1637632800,5202,21.754,28.17,-6.416
1637627598,1637636400,8802,19.666,27.84,-8.174
1637627598,1637640000,12402,17.164,27.95,-10.786
1637779381,1637780400,1019,62.728,58.89,3.838
1637779381,1637784000,4619,62.728,57.54,5.188
1637779381,1637787600,8219,61.432,52.7,8.732
1637779381,1637791200,11819,57.454,52.59,4.864
1637356404,1637359200,2796,39.34,39.76,-0.42
1637356404,1637362800,6396,37.396,37.29,0.106
1637356404,1637366400,9996,35.002,35.38,-0.378
1637356404,1637370000,13596,31.78,36.05,-4.27
1637963695,1637964000,305,41.356,41.79,-0.434
1637963695,1637967600,3905,40.564,41.11,-0.546
1637963695,1637971200,7505,39.286,41.56,-2.274
1637963695,1637974800,11105,37.756,39.76,-2.004
1637880610,1637881200,590,31.656,35.15,-3.494
1637880610,1637884800,4190,30.81,35.6,-4.79
1637880610,1637888400,7790,29.766,35.71,-5.944
1637880610,1637892000,11390,28.686,33.69,-5.004
1637464865,1637467200,2335,46.434,45.84,0.594
1637464865,1637470800,5935,46.38,45.28,1.1
1637464865,1637474400,9535,47.082,45.72,1.362
1637464865,1637478000,13135,47.73,45.84,1.89
1637374495,1637377200,2705,35.186,35.94,-0.754
1637374495,1637380800,6305,34.556,35.38,-0.824
1637374495,1637384400,9905,33.728,37.17,-3.442
1637374495,1637388000,13505,32.954,37.74,-4.786
1637837247,1637838000,753,43.108,43.59,-0.482
1637837247,1637841600,4353,43.99,44.6,-0.61
1637837247,1637845200,7953,45.322,43.36,1.962
1637837247,1637848800,11553,49.336,56.3,-6.964
1637978145,1637978400,255,38.248,39.31,-1.062
1637978145,1637982000,3855,37.348,37.85,-0.502
1637978145,1637985600,7455,36.358,36.16,0.198
1637978145,1637989200,11055,35.152,36.72,-1.568
1637439577,1637442000,2423,47.372,45.84,1.532
1637439577,1637445600,6023,45.194,45.5,-0.306
1637439577,1637449200,9623,42.026,45.5,-3.474
1637439577,1637452800,13223,38.768,45.28,-6.512
1637475701,1637478000,2299,46.24,45.84,0.4
1637475701,1637481600,5899,47.104,46.06,1.044
1637475701,1637485200,9499,47.896,45.61,2.286
1637475701,1637488800,13099,48.4,43.59,4.81
1637797442,1637798400,958,55.04,53.26,1.78
1637797442,1637802000,4558,54.59,52.36,2.23
1637797442,1637805600,8158,53.942,51.46,2.482
1637797442,1637809200,11758,53.204,51.01,2.194
1638025105,1638025200,95,54.428,83.19,-28.762
1638025105,1638028800,3695,55.472,81.5,-26.028
1637743259,1637744400,1141,35.978,36.84,-0.862
1637743259,1637748000,4741,36.464,35.83,0.634
1637743259,1637751600,8341,36.968,34.47,2.498
1637743259,1637755200,11941,37.508,39.31,-1.802
1637540781,1637542800,2019,35.812,36.05,-0.238
1637540781,1637546400,5619,35.362,34.25,1.112
1637540781,1637550000,9219,35.182,33.01,2.172
1637540781,1637553600,12819,35.218,31.77,3.448
1637970920,1637971200,280,41.176,41.56,-0.384
1637970920,1637974800,3880,40.294,39.76,0.534
1637970920,1637978400,7480,38.89,39.31,-0.42
1637970920,1637982000,11080,37.576,37.85,-0.274
1637634824,1637636400,1576,20.932,27.84,-6.908
1637634824,1637640000,5176,19.636,27.95,-8.314
1637634824,1637643600,8776,18.07,27.5,-9.43
1637634824,1637647200,12376,16.144,27.39,-11.246
1637537169,1637539200,2031,37.116,37.96,-0.844
1637537169,1637542800,5631,36.54,36.05,0.49
1637537169,1637546400,9231,35.64,34.25,1.39
1637537169,1637550000,12831,35.676,33.01,2.666
1637819121,1637820000,879,49.84,47.97,1.87
1637819121,1637823600,4479,50.002,45.05,4.952
1637819121,1637827200,8079,50.272,45.61,4.662
1637819121,1637830800,11679,51.136,45.61,5.526
1637457639,1637460000,2361,44.632,45.16,-0.528
1637457639,1637463600,5961,44.254,45.5,-1.246
1637457639,1637467200,9561,44.056,45.84,-1.784
1637457639,1637470800,13161,43.552,45.28,-1.728
1637671006,1637672400,1394,39.798,37.17,2.628
1637671006,1637676000,4994,40.482,72.05,-31.568
1637671006,1637679600,8594,42.39,82.18,-39.79
1637671006,1637683200,12194,45.108,87.13,-42.022
1637631211,1637632800,1589,21.758,28.17,-6.412
1637631211,1637636400,5189,20.336,27.84,-7.504
1637631211,1637640000,8789,18.446,27.95,-9.504
1637631211,1637643600,12389,16.358,27.5,-11.142
1637725199,1637726400,1201,31.582,35.15,-3.568
1637725199,1637730000,4801,31.654,35.38,-3.726
1637725199,1637733600,8401,31.618,37.63,-6.012
1637725199,1637737200,12001,31.6,37.63,-6.03
1637782993,1637784000,1007,62.366,57.54,4.826
1637782993,1637787600,4607,61.484,52.7,8.784
1637782993,1637791200,8207,58.37,52.59,5.78
1637782993,1637794800,11807,55.04,52.25,2.79
1637840860,1637841600,740,40.944,44.6,-3.656
1637840860,1637845200,4340,42.582,43.36,-0.778
1637840860,1637848800,7940,46.146,56.3,-10.154
1637840860,1637852400,11540,52.104,68.11,-16.006
1637443190,1637445600,2410,45.698,45.5,0.198
1637443190,1637449200,6010,43.412,45.5,-2.088
1637443190,1637452800,9610,40.748,45.28,-4.532
1637443190,1637456400,13210,38.48,44.94,-6.46
1637392557,1637395200,2643,36.658,37.29,-0.632
1637392557,1637398800,6243,37.18,37.06,0.12
1637392557,1637402400,9843,37.504,36.28,1.224
1637392557,1637406000,13443,38.728,34.92,3.808
1637598697,1637600400,1703,39.072,81.84,-42.768
1637598697,1637604000,5303,38.316,47.19,-8.874
1637598697,1637607600,8903,36.912,42.35,-5.438
1637598697,1637611200,12503,34.338,39.2,-4.862
1637649333,1637650800,1467,20.804,27.39,-6.586
1637649333,1637654400,5067,20.012,27.5,-7.488
1637649333,1637658000,8667,19.04,26.83,-7.79
1637649333,1637661600,12267,18.068,26.38,-8.312
1637848090,1637848800,710,42.186,56.3,-14.114
1637848090,1637852400,4310,45.174,68.11,-22.936
1637848090,1637856000,7910,49.836,77.68,-27.844
1637848090,1637859600,11510,55.398,74.3,-18.902
1638021493,1638021600,107,58.444,72.16,-13.716
1638021493,1638025200,3707,59.902,83.19,-23.288
1638021493,1638028800,7307,62.8,81.5,-18.7
1637385333,1637388000,2667,36.804,37.74,-0.936
1637385333,1637391600,6267,36.966,38.08,-1.114
1637385333,1637395200,9867,37.146,37.29,-0.144
1637385333,1637398800,13467,37.254,37.06,0.194
1637775769,1637776800,1031,69.566,61.36,8.206
1637775769,1637780400,4631,70.106,58.89,11.216
1637775769,1637784000,8231,70.628,57.54,13.088
1637775769,1637787600,11831,69.278,52.7,16.578
1637750483,1637751600,1117,31.258,34.47,-3.212
1637750483,1637755200,4717,31.978,39.31,-7.332
1637750483,1637758800,8317,34.066,47.75,-13.684
1637750483,1637762400,11917,39.088,-196.6,235.688
1637869773,1637870400,627,36.192,40.55,-4.358
1637869773,1637874000,4227,35.058,36.39,-1.332
1637869773,1637877600,7827,31.926,36.16,-4.234
1637869773,1637881200,11427,29.748,35.15,-5.402
1637638436,1637640000,1564,20.854,27.95,-7.096
1637638436,1637643600,5164,19.756,27.5,-7.744
1637638436,1637647200,8764,18.334,27.39,-9.056
1637638436,1637650800,12364,16.498,27.39,-10.892
1637981757,1637982000,243,35.674,37.85,-2.176
1637981757,1637985600,3843,34.648,36.16,-1.512
1637981757,1637989200,7443,33.478,36.72,-3.242
1637981757,1637992800,11043,32.146,37.17,-5.024
1637757708,1637758800,1092,48.236,47.75,0.486
1637757708,1637762400,4692,50.612,-196.6,247.212
1637757708,1637766000,8292,54.86,78.13,-23.27
1637757708,1637769600,11892,60.368,80.49,-20.122
1637305743,1637308800,3057,21.682,28.96,-7.278
1637305743,1637312400,6657,20.818,28.51,-7.692
1637305743,1637316000,10257,19.378,27.84,-8.462
1637305743,1637319600,13857,17.092,29.19,-12.098
1637577023,1637578800,1777,21.294,28.96,-7.666
1637577023,1637582400,5377,21.132,33.46,-12.328
1637577023,1637586000,8977,21.042,37.63,-16.588
1637577023,1637589600,12577,23.04,68.56,-45.52
1637345563,1637348400,2837,44.636,46.17,-1.534
1637345563,1637352000,6437,44.816,43.59,1.226
1637345563,1637355600,10037,44.096,41.0,3.096
1637345563,1637359200,13637,39.632,39.76,-0.128
1637580635,1637582400,1765,29.73,33.46,-3.73
1637580635,1637586000,5365,29.802,37.63,-7.828
1637580635,1637589600,8965,31.278,68.56,-37.282
1637580635,1637593200,12565,32.592,81.72,-49.128
1637291282,1637294400,3118,23.934,30.42,-6.486
1637291282,1637298000,6718,22.098,30.09,-7.992
1637291282,1637301600,10318,19.902,29.19,-9.288
1637291282,1637305200,13918,17.31,28.63,-11.32
1637526333,1637528400,2067,42.276,41.79,0.486
1637526333,1637532000,5667,40.818,40.33,0.488
1637526333,1637535600,9267,39.45,39.65,-0.2
1637526333,1637539200,12867,38.172,37.96,0.212
1637522722,1637524800,2078,44.8,44.49,0.31
1637522722,1637528400,5678,44.008,41.79,2.218
1637522722,1637532000,9278,41.92,40.33,1.59
1637522722,1637535600,12878,40.192,39.65,0.542
1637934796,1637935200,404,48.544,56.3,-7.756
1637934796,1637938800,4004,47.482,70.14,-22.658
1637934796,1637942400,7604,46.888,75.76,-28.872
1637934796,1637946000,11204,46.258,74.07,-27.812
1637678232,1637679600,1368,46.312,82.18,-35.868
1637678232,1637683200,4968,46.96,87.13,-40.17
1637678232,1637686800,8568,48.31,82.18,-33.87
1637678232,1637690400,12168,49.912,52.47,-2.558
1637435965,1637438400,2435,48.924,47.41,1.514
1637435965,1637442000,6035,48.564,45.84,2.724
1637435965,1637445600,9635,45.468,45.5,-0.032
1637435965,1637449200,13235,41.742,45.5,-3.758
1637884222,1637884800,578,31.224,35.6,-4.376
1637884222,1637888400,4178,30.234,35.71,-5.476
1637884222,1637892000,7778,29.082,33.69,-4.608
1637884222,1637895600,11378,27.498,31.55,-4.052
1637493762,1637496000,2238,41.92,43.59,-1.67
1637493762,1637499600,5838,43.792,48.31,-4.518
1637493762,1637503200,9438,47.446,74.64,-27.194
1637493762,1637506800,13038,52.342,84.65,-32.308
1637363632,1637366400,2768,34.628,35.38,-0.752
1637363632,1637370000,6368,33.314,36.05,-2.736
1637363632,1637373600,9968,31.802,36.16,-4.358
1637363632,1637377200,13568,30.272,35.94,-5.668
1637999818,1638000000,182,32.306,34.36,-2.054
1637999818,1638003600,3782,31.766,34.14,-2.374
1637999818,1638007200,7382,31.01,33.69,-2.68
1637999818,1638010800,10982,30.182,33.35,-3.168
1637790217,1637791200,983,52.754,52.59,0.164
1637790217,1637794800,4583,51.188,52.25,-1.062
1637790217,1637798400,8183,49.046,53.26,-4.214
1637790217,1637802000,11783,46.4,52.36,-5.96
1637717974,1637719200,1226,34.506,37.4,-2.894
1637717974,1637722800,4826,34.092,35.49,-1.398
1637717974,1637726400,8426,33.48,35.15,-1.67
1637717974,1637730000,12026,32.832,35.38,-2.548
1638028718,1638028800,82,62.022,81.5,-19.478
1637414230,1637416800,2570,47.03,56.75,-9.72
1637414230,1637420400,6170,50.036,48.54,1.496
1637414230,1637424000,9770,54.158,50.67,3.488
1637414230,1637427600,13370,58.982,50.11,8.872
1637609534,1637611200,1666,36.874,39.2,-2.326
1637609534,1637614800,5266,35.488,36.84,-1.352
1637609534,1637618400,8866,32.914,33.24,-0.326
1637609534,1637622000,12466,29.62,31.77,-2.15
1637761320,1637762400,1080,58.05,-196.6,254.65
1637761320,1637766000,4680,60.606,78.13,-17.524
1637761320,1637769600,8280,64.584,80.49,-15.906
1637761320,1637773200,11880,69.462,85.44,-15.978
1637764932,1637766000,1068,61.738,78.13,-16.392
1637764932,1637769600,4668,63.556,80.49,-16.934
1637764932,1637773200,8268,66.454,85.44,-18.986
1637764932,1637776800,11868,70.0,61.36,8.64
1637714362,1637715600,1238,34.048,36.72,-2.672
1637714362,1637719200,4838,33.292,37.4,-4.108
1637714362,1637722800,8438,32.356,35.49,-3.134
1637714362,1637726400,12038,31.24,35.15,-3.91
1637602310,1637604000,1690,42.582,47.19,-4.608
1637602310,1637607600,5290,41.484,42.35,-0.866
1637602310,1637611200,8890,39.414,39.2,0.214
1637602310,1637614800,12490,36.552,36.84,-0.288
1637844476,1637845200,724,41.446,43.36,-1.914
1637844476,1637848800,4324,43.678,56.3,-12.622
1637844476,1637852400,7924,48.16,68.11,-19.95
1637844476,1637856000,11524,54.064,77.68,-23.616
1637421516,1637424000,2484,48.326,50.67,-2.344
1637421516,1637427600,6084,50.324,50.11,0.214
1637421516,1637431200,9684,52.862,49.55,3.312
1637421516,1637434800,13284,55.562,48.88,6.682
1637584247,1637586000,1753,36.736,37.63,-0.894
1637584247,1637589600,5353,37.636,68.56,-30.924
1637584247,1637593200,8953,38.896,81.72,-42.824
1637584247,1637596800,12553,39.832,84.99,-45.158
1637468477,1637470800,2323,46.524,45.28,1.244
1637468477,1637474400,5923,46.884,45.72,1.164
1637468477,1637478000,9523,47.298,45.84,1.458
1637468477,1637481600,13123,48.774,46.06,2.714
1637728811,1637730000,1189,31.42,35.38,-3.96
1637728811,1637733600,4789,31.564,37.63,-6.066
1637728811,1637737200,8389,31.69,37.63,-5.94
1637728811,1637740800,11989,31.834,35.94,-4.106
1637184736,1637186400,1664,62.38,56.97,5.41
1637184736,1637190000,5264,59.806,54.95,4.856
1637184736,1637193600,8864,56.71,51.46,5.25
1637184736,1637197200,12464,53.506,47.86,5.646
1637652945,1637654400,1455,22.242,27.5,-5.258
1637652945,1637658000,5055,21.36,26.83,-5.47
1637652945,1637661600,8655,20.442,26.38,-5.938
1637652945,1637665200,12255,19.416,27.05,-7.634
1637551678,1637553600,1922,29.444,31.77,-2.326
1637551678,1637557200,5522,28.886,31.44,-2.554
1637551678,1637560800,9122,28.274,29.86,-1.586
1637551678,1637564400,12722,28.634,30.76,-2.126
1637490150,1637492400,2250,41.466,43.81,-2.344
1637490150,1637496000,5850,41.934,43.59,-1.656
1637490150,1637499600,9450,44.292,48.31,-4.018
1637490150,1637503200,13050,48.594,74.64,-26.046
1637562514,1637564400,1886,26.494,30.76,-4.266
1637562514,1637568000,5486,26.332,29.41,-3.078
1637562514,1637571600,9086,26.728,29.08,-2.352
1637562514,1637575200,12686,26.692,27.84,-1.148
1637721586,1637722800,1214,35.224,35.49,-0.266
1637721586,1637726400,4814,35.044,35.15,-0.106
1637721586,1637730000,8414,34.756,35.38,-0.624
1637721586,1637733600,12014,34.378,37.63,-3.252
1637923959,1637924400,441,18.448,25.81,-7.362
1637923959,1637928000,4041,16.918,28.85,-11.932
1637923959,1637931600,7641,15.172,32.34,-17.168
1637923959,1637935200,11241,13.624,56.3,-42.676
1637736035,1637737200,1165,37.384,37.63,-0.246
1637736035,1637740800,4765,37.852,35.94,1.912
1637736035,1637744400,8365,38.248,36.84,1.408
1637736035,1637748000,11965,38.608,35.83,2.778
1637159341,1637161200,1859,72.23,90.39,-18.16
1637159341,1637164800,5459,76.73,100.4,-23.67
1637159341,1637168400,9059,82.292,98.04,-15.748
1637159341,1637172000,12659,87.854,66.65,21.204
1637454027,1637456400,2373,45.338,44.94,0.398
1637454027,1637460000,5973,44.33,45.16,-0.83
1637454027,1637463600,9573,43.232,45.5,-2.268
1637454027,1637467200,13173,42.44,45.84,-3.4
1637696294,1637697600,1306,48.198,46.96,1.238
1637696294,1637701200,4906,47.532,42.13,5.402
1637696294,1637704800,8506,44.868,38.3,6.568
1637696294,1637708400,12106,41.016,36.61,4.406
1637754095,1637755200,1105,34.522,39.31,-4.788
1637754095,1637758800,4705,36.106,47.75,-11.644
1637754095,1637762400,8305,40.102,-196.6,236.702
1637754095,1637766000,11905,45.682,78.13,-32.448
1637811894,1637812800,906,52.63,50.22,2.41
1637811894,1637816400,4506,52.9,49.21,3.69
1637811894,1637820000,8106,53.116,47.97,5.146
1637811894,1637823600,11706,53.638,45.05,8.588
1637381721,1637384400,2679,35.132,37.17,-2.038
1637381721,1637388000,6279,35.15,37.74,-2.59
1637381721,1637391600,9879,35.06,38.08,-3.02
1637381721,1637395200,13479,35.042,37.29,-2.248
1637591472,1637593200,1728,41.76,81.72,-39.96
1637591472,1637596800,5328,42.048,84.99,-42.942
1637591472,1637600400,8928,42.714,81.84,-39.126
1637591472,1637604000,12528,42.498,47.19,-4.692
1637931184,1637931600,416,43.216,32.34,10.876
1637931184,1637935200,4016,41.92,56.3,-14.38
1637931184,1637938800,7616,40.48,70.14,-29.66
1637931184,1637942400,11216,39.832,75.76,-35.928
1637945632,1637946000,368,42.474,74.07,-31.596
1637945632,1637949600,3968,41.772,48.2,-6.428
1637945632,1637953200,7568,40.89,44.49,-3.6
1637945632,1637956800,11168,39.378,43.36,-3.982
1637952857,1637953200,343,45.196,44.49,0.706
1637952857,1637956800,3943,44.674,43.36,1.314
1637952857,1637960400,7543,43.288,42.58,0.708
1637952857,1637964000,11143,40.462,41.79,-1.328
1637312975,1637316000,3025,20.638,27.84,-7.202
1637312975,1637319600,6625,19.126,29.19,-10.064
1637312975,1637323200,10225,16.948,34.47,-17.522
1637312975,1637326800,13825,16.03,39.54,-23.51
1637316589,1637319600,3011,20.644,29.19,-8.546
1637316589,1637323200,6611,18.916,34.47,-15.554
1637316589,1637326800,10211,17.944,39.54,-21.596
1637316589,1637330400,13811,18.592,47.75,-29.158
1637866158,1637866800,642,42.296,45.05,-2.754
1637866158,1637870400,4242,41.972,40.55,1.422
1637866158,1637874000,7842,40.172,36.39,3.782
1637866158,1637877600,11442,36.122,36.16,-0.038
1637905896,1637906400,504,21.798,28.51,-6.712
1637905896,1637910000,4104,20.808,27.5,-6.692
1637905896,1637913600,7704,19.71,27.05,-7.34
1637905896,1637917200,11304,18.234,26.38,-8.146
1637707130,1637708400,1270,33.276,36.61,-3.334
1637707130,1637712000,4870,31.908,35.49,-3.582
1637707130,1637715600,8470,30.144,36.72,-6.576
1637707130,1637719200,12070,28.218,37.4,-9.182
1637349177,1637352000,2823,45.338,43.59,1.748
1637349177,1637355600,6423,44.78,41.0,3.78
1637349177,1637359200,10023,41.288,39.76,1.528
1637349177,1637362800,13623,38.228,37.29,0.938
1637309360,1637312400,3040,21.434,28.51,-7.076
1637309360,1637316000,6640,20.282,27.84,-7.558
1637309360,1637319600,10240,18.374,29.19,-10.816
1637309360,1637323200,13840,15.8,34.47,-18.67
1637515436,1637517600,2164,54.162,54.28,-0.118
1637515436,1637521200,5764,54.954,47.41,7.544
1637515436,1637524800,9364,54.72,44.49,10.23
1637515436,1637528400,12964,53.226,41.79,11.436
