time_measured,estimation_time,time_diff_seconds,predicted_temp_f,actual_temp_f,diff_f
1637887835,1637888400,565,30.436,35.71,-5.274
1637887835,1637892000,4165,29.572,33.69,-4.118
1637887835,1637895600,7765,28.348,31.55,-3.202
1637887835,1637899200,11365,26.422,29.75,-3.328
1637410617,1637413200,2583,41.394,48.42,-7.026
1637410617,1637416800,6183,44.85,56.75,-11.9
1637410617,1637420400,9783,49.116,48.54,0.576
1637410617,1637424000,13383,54.462,50.67,3.792
1637833575,1637834400,825,41.16,44.15,-2.99
1637833575,1637838000,4425,42.06,43.59,-1.53
1637833575,1637841600,8025,43.176,44.6,-1.424
1637833575,1637845200,11625,44.85,43.36,1.49
1637956469,1637956800,331,39.002,43.36,-4.358
1637956469,1637960400,3931,38.408,42.58,-4.172
1637956469,1637964000,7531,36.572,41.79,-5.218
1637956469,1637967600,11131,34.484,41.11,-6.626
1637938408,1637938800,392,55.578,70.14,-14.562
1637938408,1637942400,3992,54.894,75.76,-20.866
1637938408,1637946000,7592,54.48,74.07,-19.59
1637938408,1637949600,11192,53.976,48.2,5.776
1637173826,1637175600,1774,60.35,64.85,-4.5
1637173826,1637179200,5374,60.206,62.6,-2.394
1637173826,1637182800,8974,58.298,61.14,-2.842
1637173826,1637186400,12574,53.33,56.97,-3.64
1637320203,1637323200,2997,23.376,34.47,-11.094
1637320203,1637326800,6597,22.404,39.54,-17.136
1637320203,1637330400,10197,22.728,47.75,-25.022
1637320203,1637334000,13797,24.204,46.96,-22.756
1637352791,1637355600,2809,39.292,41.0,-1.708
1637352791,1637359200,6409,36.916,39.76,-2.844
1637352791,1637362800,10009,34.342,37.29,-2.948
1637352791,1637366400,13609,31.462,35.38,-3.918
1637703517,1637704800,1283,32.522,38.3,-5.778
1637703517,1637708400,4883,30.938,36.61,-5.672
1637703517,1637712000,8483,28.724,35.49,-6.766
1637703517,1637715600,12083,26.24,36.72,-10.48
1637793830,1637794800,970,46.11,52.25,-6.14
1637793830,1637798400,4570,45.174,53.26,-8.086
1637793830,1637802000,8170,43.734,52.36,-8.626
1637793830,1637805600,11770,42.258,51.46,-9.202
1637181076,1637182800,1724,58.44,61.14,-2.7
1637181076,1637186400,5324,56.064,56.97,-0.906
1637181076,1637190000,8924,52.518,54.95,-2.432
1637181076,1637193600,12524,48.792,51.46,-2.668
1637642049,1637643600,1551,21.702,27.5,-5.798
1637642049,1637647200,5151,20.748,27.39,-6.642
1637642049,1637650800,8751,19.416,27.39,-7.974
1637642049,1637654400,12351,17.616,27.5,-9.884
1637461252,1637463600,2348,42.598,45.5,-2.902
1637461252,1637467200,5948,42.58,45.84,-3.26
1637461252,1637470800,9548,42.328,45.28,-2.952
1637461252,1637474400,13148,43.12,45.72,-2.6
1638010656,1638010800,144,28.4,33.35,-4.95
1638010656,1638014400,3744,28.148,36.95,-8.802
1638010656,1638018000,7344,28.904,43.59,-14.686
1638010656,1638021600,10944,32.234,72.16,-39.926
1637294901,1637298000,3099,24.372,30.09,-5.718
1637294901,1637301600,6699,23.058,29.19,-6.132
1637294901,1637305200,10299,21.294,28.63,-7.336
1637294901,1637308800,13899,19.314,28.96,-9.646
1637338274,1637341200,2926,46.112,60.57,-14.458
1637338274,1637344800,6526,47.066,48.99,-1.924
1637338274,1637348400,10126,48.218,46.17,2.048
1637338274,1637352000,13726,48.866,43.59,5.276
1637942020,1637942400,380,59.616,75.76,-16.144
1637942020,1637946000,3980,58.932,74.07,-15.138
1637942020,1637949600,7580,58.284,48.2,10.084
1637942020,1637953200,11180,57.312,44.49,12.822
1637407004,1637409600,2596,32.304,41.11,-8.806
1637407004,1637413200,6196,34.104,48.42,-14.316
1637407004,1637416800,9796,38.622,56.75,-18.128
1637407004,1637420400,13396,43.59,48.54,-4.95
1637166583,1637168400,1817,82.186,98.04,-15.854
1637166583,1637172000,5417,84.292,66.65,17.642
1637166583,1637175600,9017,86.452,64.85,21.602
1637166583,1637179200,12617,87.73,62.6,25.13
1637450414,1637452800,2386,41.212,45.28,-4.068
1637450414,1637456400,5986,39.97,44.94,-4.97
1637450414,1637460000,9586,38.26,45.16,-6.9
1637450414,1637463600,13186,36.568,45.5,-8.932
1637486538,1637488800,2262,42.226,43.59,-1.364
1637486538,1637492400,5862,42.442,43.81,-1.368
1637486538,1637496000,9462,43.054,43.59,-0.536
1637486538,1637499600,13062,46.096,48.31,-2.214
1637732423,1637733600,1177,32.542,37.63,-5.088
1637732423,1637737200,4777,32.722,37.63,-4.908
1637732423,1637740800,8377,32.92,35.94,-3.02
1637732423,1637744400,11977,33.01,36.84,-3.83
1637472090,1637474400,2310,43.518,45.72,-2.202
1637472090,1637478000,5910,44.022,45.84,-1.818
1637472090,1637481600,9510,45.39,46.06,-0.67
1637472090,1637485200,13110,46.416,45.61,0.806
1637801054,1637802000,946,49.482,52.36,-2.878
1637801054,1637805600,4546,49.446,51.46,-2.014
1637801054,1637809200,8146,49.302,51.01,-1.708
1637801054,1637812800,11746,49.176,50.22,-1.044
1637674619,1637676000,1381,34.002,72.05,-38.048
1637674619,1637679600,4981,34.686,82.18,-47.494
1637674619,1637683200,8581,36.324,87.13,-50.806
1637674619,1637686800,12181,38.538,82.18,-43.642
1637992594,1637992800,206,33.172,37.17,-3.998
1637992594,1637996400,3806,32.758,37.17,-4.412
1637992594,1638000000,7406,32.146,34.36,-2.214
1637992594,1638003600,11006,31.48,34.14,-2.66
1637829960,1637830800,840,43.574,45.61,-2.036
1637829960,1637834400,4440,44.006,44.15,-0.144
1637829960,1637838000,8040,45.41,43.59,1.82
1637829960,1637841600,11640,46.634,44.6,2.034
1637555290,1637557200,1910,27.876,31.44,-3.564
1637555290,1637560800,5510,27.462,29.86,-2.398
1637555290,1637564400,9110,27.75,30.76,-3.01
1637555290,1637568000,12710,28.056,29.41,-1.354
1637620372,1637622000,1628,25.162,31.77,-6.608
1637620372,1637625600,5228,23.812,29.86,-6.048
1637620372,1637629200,8828,22.03,28.96,-6.93
1637620372,1637632800,12428,19.24,28.17,-8.93
1637569799,1637571600,1801,24.586,29.08,-4.494
1637569799,1637575200,5401,24.55,27.84,-3.29
1637569799,1637578800,9001,24.604,28.96,-4.356
1637569799,1637582400,12601,23.47,33.46,-9.99
1637876998,1637877600,602,28.744,36.16,-7.416
1637876998,1637881200,4202,27.556,35.15,-7.594
1637876998,1637884800,7802,26.044,35.6,-9.556
1637876998,1637888400,11402,24.388,35.71,-11.322
1637685456,1637686800,1344,59.072,82.18,-23.108
1637685456,1637690400,4944,59.54,52.47,7.07
1637685456,1637694000,8544,60.008,50.22,9.788
1637685456,1637697600,12144,60.35,46.96,13.39
1637858930,1637859600,670,51.71,74.3,-22.59
1637858930,1637863200,4270,52.196,47.19,5.006
1637858930,1637866800,7870,53.438,45.05,8.388
1637858930,1637870400,11470,54.338,40.55,13.788
1638017881,1638018000,119,38.82,43.59,-4.77
1638017881,1638021600,3719,40.26,72.16,-31.9
1638017881,1638025200,7319,43.32,83.19,-39.87
1638017881,1638028800,10919,47.766,81.5,-33.734
1637913121,1637913600,479,19.742,27.05,-7.308
1637913121,1637917200,4079,19.04,26.38,-7.34
1637913121,1637920800,7679,17.258,26.6,-9.342
1637913121,1637924400,11279,15.278,25.81,-10.532
1637323817,1637326800,2983,28.162,39.54,-11.378
1637323817,1637330400,6583,28.27,47.75,-19.48
1637323817,1637334000,10183,29.566,46.96,-17.394
1637323817,1637337600,13783,31.708,48.09,-16.382
1637533558,1637535600,2042,36.016,39.65,-3.634
1637533558,1637539200,5642,35.368,37.96,-2.592
1637533558,1637542800,9242,34.594,36.05,-1.456
1637533558,1637546400,12842,33.424,34.25,-0.826
1637739646,1637740800,1154,32.286,35.94,-3.654
1637739646,1637744400,4754,32.772,36.84,-4.068
1637739646,1637748000,8354,33.204,35.83,-2.626
1637739646,1637751600,11954,33.69,34.47,-0.78
1637855317,1637856000,683,64.762,77.68,-12.918
1637855317,1637859600,4283,65.842,74.3,-8.458
1637855317,1637863200,7883,67.822,47.19,20.632
1637855317,1637866800,11483,70.468,45.05,25.418
1638003431,1638003600,169,28.386,34.14,-5.754
1638003431,1638007200,3769,27.954,33.69,-5.736
1638003431,1638010800,7369,27.378,33.35,-5.972
1638003431,1638014400,10969,26.73,36.95,-10.22
1637573411,1637575200,1789,24.17,27.84,-3.67
1637573411,1637578800,5389,24.206,28.96,-4.754
1637573411,1637582400,8989,23.666,33.46,-9.794
1637573411,1637586000,12589,23.522,37.63,-14.108
1637927571,1637928000,429,22.714,28.85,-6.136
1637927571,1637931600,4029,21.4,32.34,-10.94
1637927571,1637935200,7629,20.14,56.3,-36.16
1637927571,1637938800,11229,18.628,70.14,-51.512
1637519049,1637521200,2151,45.34,47.41,-2.07
1637519049,1637524800,5751,45.25,44.49,0.76
1637519049,1637528400,9351,44.044,41.79,2.254
1637519049,1637532000,12951,41.398,40.33,1.068
1637544393,1637546400,2007,30.252,34.25,-3.998
1637544393,1637550000,5607,30.162,33.01,-2.848
1637544393,1637553600,9207,30.27,31.77,-1.5
1637544393,1637557200,12807,29.586,31.44,-1.854
1637804667,1637805600,933,48.94,51.46,-2.52
1637804667,1637809200,4533,49.066,51.01,-1.944
1637804667,1637812800,8133,49.192,50.22,-1.028
1637804667,1637816400,11733,49.498,49.21,0.288
1637681844,1637683200,1356,58.568,87.13,-28.562
1637681844,1637686800,4956,59.216,82.18,-22.964
1637681844,1637690400,8556,60.26,52.47,7.79
1637681844,1637694000,12156,61.106,50.22,10.886
1637425128,1637427600,2472,48.792,50.11,-1.318
1637425128,1637431200,6072,50.358,49.55,0.808
1637425128,1637434800,9672,52.23,48.88,3.35
1637425128,1637438400,13272,53.49,47.41,6.08
1637170203,1637172000,1797,63.718,66.65,-2.932
1637170203,1637175600,5397,64.51,64.85,-0.34
1637170203,1637179200,8997,64.708,62.6,2.108
1637170203,1637182800,12597,62.116,61.14,0.976
1637974533,1637974800,267,34.392,39.76,-5.368
1637974533,1637978400,3867,33.258,39.31,-6.052
1637974533,1637982000,7467,31.998,37.85,-5.852
1637974533,1637985600,11067,30.63,36.16,-5.53
1637334660,1637337600,2940,44.004,48.09,-4.086
1637334660,1637341200,6540,44.922,60.57,-15.648
1637334660,1637344800,10140,46.38,48.99,-2.61
1637334660,1637348400,13740,47.91,46.17,1.74
1637428740,1637431200,2460,49.568,49.55,0.018
1637428740,1637434800,6060,50.72,48.88,1.84
1637428740,1637438400,9660,51.548,47.41,4.138
1637428740,1637442000,13260,51.08,45.84,5.24
1637548006,1637550000,1994,28.204,33.01,-4.806
1637548006,1637553600,5594,28.078,31.77,-3.692
1637548006,1637557200,9194,27.43,31.44,-4.01
1637548006,1637560800,12794,26.818,29.86,-3.042
1637692680,1637694000,1320,44.652,50.22,-5.568
1637692680,1637697600,4920,44.418,46.96,-2.542
1637692680,1637701200,8520,43.41,42.13,1.28
1637692680,1637704800,12120,39.792,38.3,1.492
1637815509,1637816400,891,46.452,49.21,-2.758
1637815509,1637820000,4491,46.524,47.97,-1.446
1637815509,1637823600,8091,46.794,45.05,1.744
1637815509,1637827200,11691,47.082,45.61,1.472
1637826346,1637827200,854,44.118,45.61,-1.492
1637826346,1637830800,4454,44.55,45.61,-1.06
1637826346,1637834400,8054,44.892,44.15,0.742
1637826346,1637838000,11654,46.728,43.59,3.138
1637595084,1637596800,1716,52.36,84.99,-32.63
1637595084,1637600400,5316,52.342,81.84,-29.498
1637595084,1637604000,8916,51.856,47.19,4.666
1637595084,1637607600,12516,50.614,42.35,8.264
1637613147,1637614800,1653,32.196,36.84,-4.644
1637613147,1637618400,5253,30.738,33.24,-2.502
1637613147,1637622000,8853,28.416,31.77,-3.354
1637613147,1637625600,12453,25.806,29.86,-4.054
1637529946,1637532000,2054,36.39,40.33,-3.94
1637529946,1637535600,5654,35.4,39.65,-4.25
1637529946,1637539200,9254,34.374,37.96,-3.586
1637529946,1637542800,12854,33.204,36.05,-2.846
1637768545,1637769600,1055,64.164,80.49,-16.326
1637768545,1637773200,4655,65.586,85.44,-19.854
1637768545,1637776800,8255,67.782,61.36,6.422
1637768545,1637780400,11855,70.356,58.89,11.466
1637566127,1637568000,1873,26.524,29.41,-2.886
1637566127,1637571600,5473,26.686,29.08,-2.394
1637566127,1637575200,9073,26.632,27.84,-1.208
1637566127,1637578800,12673,26.686,28.96,-2.274
1637988981,1637989200,219,33.69,36.72,-3.03
1637988981,1637992800,3819,32.952,37.17,-4.218
1637988981,1637996400,7419,32.178,37.17,-4.992
1637988981,1638000000,11019,30.792,34.36,-3.568
1637699906,1637701200,1294,37.306,42.13,-4.824
1637699906,1637704800,4894,35.938,38.3,-2.362
1637699906,1637708400,8494,33.112,36.61,-3.498
1637699906,1637712000,12094,30.052,35.49,-5.438
1637399781,1637402400,2619,33.53,36.28,-2.75
1637399781,1637406000,6219,34.628,34.92,-0.292
1637399781,1637409600,9819,35.204,41.11,-5.906
1637399781,1637413200,13419,37.904,48.42,-10.516
1637341889,1637344800,2911,51.042,48.99,2.052
1637341889,1637348400,6511,51.708,46.17,5.538
1637341889,1637352000,10111,52.086,43.59,8.496
1637341889,1637355600,13711,51.186,41.0,10.186
1637898671,1637899200,529,23.646,29.75,-6.104
1637898671,1637902800,4129,22.548,28.74,-6.192
1637898671,1637906400,7729,20.874,28.51,-7.636
1637898671,1637910000,11329,18.966,27.5,-8.534
1637497374,1637499600,2226,43.146,48.31,-5.164
1637497374,1637503200,5826,46.08,74.64,-28.56
1637497374,1637506800,9426,50.31,84.65,-34.34
1637497374,1637510400,13026,56.232,56.97,-0.738
1637479314,1637481600,2286,43.54,46.06,-2.52
1637479314,1637485200,5886,43.972,45.61,-1.638
1637479314,1637488800,9486,44.242,43.59,0.652
1637479314,1637492400,13086,44.17,43.81,0.36
1637663782,1637665200,1418,22.14,27.05,-4.91
1637663782,1637668800,5018,21.438,30.99,-9.552
1637663782,1637672400,8618,21.942,37.17,-15.228
1637663782,1637676000,12218,24.552,72.05,-47.498
1637746870,1637748000,1130,31.748,35.83,-4.082
1637746870,1637751600,4730,32.252,34.47,-2.218
1637746870,1637755200,8330,32.774,39.31,-6.536
1637746870,1637758800,11930,35.348,47.75,-12.402
1637587860,1637589600,1740,31.516,68.56,-37.044
1637587860,1637593200,5340,32.506,81.72,-49.214
1637587860,1637596800,8940,33.388,84.99,-51.602
1637587860,1637600400,12540,34.126,81.84,-47.714
1637822734,1637823600,866,41.432,45.05,-3.618
1637822734,1637827200,4466,41.756,45.61,-3.854
1637822734,1637830800,8066,42.494,45.61,-3.116
1637822734,1637834400,11666,42.89,44.15,-1.26
1637645661,1637647200,1539,22.692,27.39,-4.698
1637645661,1637650800,5139,21.918,27.39,-5.472
1637645661,1637654400,8739,20.694,27.5,-6.806
1637645661,1637658000,12339,19.272,26.83,-7.558
1637177446,1637179200,1754,60.24,62.6,-2.36
1637177446,1637182800,5354,58.98,61.14,-2.16
1637177446,1637186400,8954,55.11,56.97,-1.86
1637177446,1637190000,12554,50.772,54.95,-4.178
1637388945,1637391600,2655,34.99,38.08,-3.09
1637388945,1637395200,6255,35.368,37.29,-1.922
1637388945,1637398800,9855,35.8,37.06,-1.26
1637388945,1637402400,13455,35.944,36.28,-0.336
1637667394,1637668800,1406,24.782,30.99,-6.208
1637667394,1637672400,5006,24.62,37.17,-12.55
1637667394,1637676000,8606,26.276,72.05,-45.774
1637667394,1637679600,12206,28.85,82.18,-53.33
1637967308,1637967600,292,36.628,41.11,-4.482
1637967308,1637971200,3892,35.854,41.56,-5.706
1637967308,1637974800,7492,34.738,39.76,-5.022
1637967308,1637978400,11092,33.244,39.31,-6.066
1637660169,1637661600,1431,21.958,26.38,-4.422
1637660169,1637665200,5031,21.418,27.05,-5.632
1637660169,1637668800,8631,20.788,30.99,-10.202
1637660169,1637672400,12231,21.994,37.17,-15.176
1637508211,1637510400,2189,60.942,56.97,3.972
1637508211,1637514000,5789,63.444,85.32,-21.876
1637508211,1637517600,9389,65.226,54.28,10.946
1637508211,1637521200,12989,66.756,47.41,19.346
1637403393,1637406000,2607,33.858,34.92,-1.062
1637403393,1637409600,6207,34.578,41.11,-6.532
1637403393,1637413200,9807,36.864,48.42,-11.556
1637403393,1637416800,13407,42.48,56.75,-14.27
1637378109,1637380800,2691,32.178,35.38,-3.202
1637378109,1637384400,6291,31.836,37.17,-5.334
1637378109,1637388000,9891,31.458,37.74,-6.282
1637378109,1637391600,13491,30.972,38.08,-7.108
1637960082,1637960400,318,37.924,42.58,-4.656
1637960082,1637964000,3918,36.772,41.79,-5.018
1637960082,1637967600,7518,35.044,41.11,-6.066
1637960082,1637971200,11118,32.884,41.56,-8.676
1637511824,1637514000,2176,58.438,85.32,-26.882
1637511824,1637517600,5776,59.734,54.28,5.454
1637511824,1637521200,9376,60.796,47.41,13.386
1637511824,1637524800,12976,60.562,44.49,16.072
1637360017,1637362800,2783,33.872,37.29,-3.418
1637360017,1637366400,6383,32.306,35.38,-3.074
1637360017,1637370000,9983,29.966,36.05,-6.084
1637360017,1637373600,13583,27.608,36.16,-8.552
1637331045,1637334000,2955,40.134,46.96,-6.826
1637331045,1637337600,6555,40.998,48.09,-7.092
1637331045,1637341200,10155,42.636,60.57,-17.934
1637331045,1637344800,13755,44.688,48.99,-4.302
1638014268,1638014400,132,31.606,36.95,-5.344
1638014268,1638018000,3732,31.93,43.59,-11.66
1638014268,1638021600,7332,34.306,72.16,-37.854
1638014268,1638025200,10932,38.122,83.19,-45.068
1637895060,1637895600,540,25.756,31.55,-5.794
1637895060,1637899200,4140,24.658,29.75,-5.092
1637895060,1637902800,7740,23.236,28.74,-5.504
1637895060,1637906400,11340,21.148,28.51,-7.362
1637396169,1637398800,2631,34.27,37.06,-2.79
1637396169,1637402400,6231,34.702,36.28,-1.578
1637396169,1637406000,9831,35.764,34.92,0.844
1637396169,1637409600,13431,35.98,41.11,-5.13
1637873386,1637874000,614,29.388,36.39,-7.002
1637873386,1637877600,4214,27.624,36.16,-8.536
1637873386,1637881200,7814,25.842,35.15,-9.308
1637873386,1637884800,11414,23.592,35.6,-12.008
1637916734,1637917200,466,20.386,26.38,-5.994
1637916734,1637920800,4066,19.36,26.6,-7.24
1637916734,1637924400,7666,17.848,25.81,-7.962
1637916734,1637928000,11266,14.428,28.85,-14.422
1637298515,1637301600,3085,23.68,29.19,-5.51
1637298515,1637305200,6685,22.474,28.63,-6.156
1637298515,1637308800,10285,20.98,28.96,-7.98
1637298515,1637312400,13885,19.09,28.51,-9.42
1637504599,1637506800,2201,50.036,84.65,-34.614
1637504599,1637510400,5801,53.24,56.97,-3.73
1637504599,1637514000,9401,57.416,85.32,-27.904
1637504599,1637517600,13001,60.242,54.28,5.962
1637786605,1637787600,995,48.148,52.7,-4.552
1637786605,1637791200,4595,46.276,52.59,-6.314
1637786605,1637794800,8195,43.504,52.25,-8.746
1637786605,1637798400,11795,40.282,53.26,-12.978
1637902284,1637902800,516,22.672,28.74,-6.068
1637902284,1637906400,4116,21.538,28.51,-6.972
1637902284,1637910000,7716,20.044,27.5,-7.456
1637902284,1637913600,11316,18.712,27.05,-8.338
1637808280,1637809200,920,48.978,51.01,-2.032
1637808280,1637812800,4520,48.924,50.22,-1.296
1637808280,1637816400,8120,48.996,49.21,-0.214
1637808280,1637820000,11720,48.942,47.97,0.972
1638007044,1638007200,156,29.93,33.69,-3.76
1638007044,1638010800,3756,29.426,33.35,-3.924
1638007044,1638014400,7356,28.832,36.95,-8.118
1638007044,1638018000,10956,29.822,43.59,-13.768
1637432353,1637434800,2447,47.388,48.88,-1.492
1637432353,1637438400,6047,47.82,47.41,0.41
1637432353,1637442000,9647,47.244,45.84,1.404
1637432353,1637445600,13247,43.302,45.5,-2.198
1637162962,1637164800,1838,81.03,100.4,-19.37
1637162962,1637168400,5438,84.162,98.04,-13.878
1637162962,1637172000,9038,87.6,66.65,20.95
1637162962,1637175600,12638,90.912,64.85,26.062
1637996206,1637996400,194,34.032,37.17,-3.138
1637996206,1638000000,3794,33.528,34.36,-0.832
1637996206,1638003600,7394,32.916,34.14,-1.224
1637996206,1638007200,10994,32.034,33.69,-1.656
1637851704,1637852400,696,54.232,68.11,-13.878
1637851704,1637856000,4296,56.086,77.68,-21.594
1637851704,1637859600,7896,59.092,74.3,-15.208
1637851704,1637863200,11496,62.854,47.19,15.664
1637710750,1637712000,1250,29.534,35.49,-5.956
1637710750,1637715600,4850,28.31,36.72,-8.41
1637710750,1637719200,8450,26.834,37.4,-10.566
1637710750,1637722800,12050,25.232,35.49,-10.258
1637891447,1637892000,553,31.026,33.69,-2.664
1637891447,1637895600,4153,30.09,31.55,-1.46
1637891447,1637899200,7753,28.578,29.75,-1.172
1637891447,1637902800,11353,26.886,28.74,-1.854
1637370881,1637373600,2719,31.316,36.16,-4.844
1637370881,1637377200,6319,30.614,35.94,-5.326
1637370881,1637380800,9919,29.282,35.38,-6.098
1637370881,1637384400,13519,27.842,37.17,-9.328
1637909508,1637910000,492,21.304,27.5,-6.196
1637909508,1637913600,4092,20.314,27.05,-6.736
1637909508,1637917200,7692,19.036,26.38,-7.344
1637909508,1637920800,11292,16.264,26.6,-10.336
1637302130,1637305200,3070,23.504,28.63,-5.126
1637302130,1637308800,6670,22.586,28.96,-6.374
1637302130,1637312400,10270,21.218,28.51,-7.292
1637302130,1637316000,13870,19.22,27.84,-8.62
1637949245,1637949600,355,40.33,48.2,-7.87
1637949245,1637953200,3955,39.754,44.49,-4.736
1637949245,1637956800,7555,38.728,43.36,-4.632
1637949245,1637960400,11155,36.622,42.58,-5.958
1637482925,1637485200,2275,44.244,45.61,-1.366
1637482925,1637488800,5875,44.37,43.59,0.78
1637482925,1637492400,9475,44.244,43.81,0.434
1637482925,1637496000,13075,43.938,43.59,0.348
1637772157,1637773200,1043,65.358,85.44,-20.082
1637772157,1637776800,4643,66.258,61.36,4.898
1637772157,1637780400,8243,67.68,58.89,8.79
1637772157,1637784000,11843,68.796,57.54,11.256
1637605922,1637607600,1678,37.204,42.35,-5.146
1637605922,1637611200,5278,35.674,39.2,-3.526
1637605922,1637614800,8878,33.316,36.84,-3.524
1637605922,1637618400,12478,29.554,33.24,-3.686
1637616759,1637618400,1641,28.27,33.24,-4.97
1637616759,1637622000,5241,26.686,31.77,-5.084
1637616759,1637625600,8841,24.652,29.86,-5.208
1637616759,1637629200,12441,22.204,28.96,-6.756
1637327431,1637330400,2969,32.756,47.75,-14.994
1637327431,1637334000,6569,33.368,46.96,-13.592
1637327431,1637337600,10169,34.898,48.09,-13.192
1637327431,1637341200,13769,37.112,60.57,-23.458
1637656557,1637658000,1443,22.172,26.83,-4.658
1637656557,1637661600,5043,21.416,26.38,-4.964
1637656557,1637665200,8643,20.57,27.05,-6.48
1637656557,1637668800,12243,19.616,30.99,-11.374
1637920347,1637920800,453,19.65,26.6,-6.95
1637920347,1637924400,4053,18.3,25.81,-7.51
1637920347,1637928000,7653,15.51,28.85,-13.34
1637920347,1637931600,11253,13.116,32.34,-19.224
1637417903,1637420400,2497,49.42,48.54,0.88
1637417903,1637424000,6097,51.94,50.67,1.27
1637417903,1637427600,9697,55.288,50.11,5.178
1637417903,1637431200,13297,59.032,49.55,9.482
1637558902,1637560800,1898,25.646,29.86,-4.214
1637558902,1637564400,5498,25.718,30.76,-5.042
1637558902,1637568000,9098,25.916,29.41,-3.494
1637558902,1637571600,12698,26.06,29.08,-3.02
1637623985,1637625600,1615,24.134,29.86,-5.726
1637623985,1637629200,5215,22.874,28.96,-6.086
1637623985,1637632800,8815,20.786,28.17,-7.384
1637623985,1637636400,12415,18.14,27.84,-9.7
1637446803,1637449200,2397,41.25,45.5,-4.25
1637446803,1637452800,5997,39.45,45.28,-5.83
1637446803,1637456400,9597,37.614,44.94,-7.326
1637446803,1637460000,13197,35.238,45.16,-9.922
1637985369,1637985600,231,31.438,36.16,-4.722
1637985369,1637989200,3831,30.466,36.72,-6.254
1637985369,1637992800,7431,29.368,37.17,-7.802
1637985369,1637996400,11031,28.27,37.17,-8.9
1637500986,1637503200,2214,45.192,74.64,-29.448
1637500986,1637506800,5814,48.234,84.65,-36.416
1637500986,1637510400,9414,52.896,56.97,-4.074
1637500986,1637514000,13014,58.35,85.32,-26.97
1637862543,1637863200,657,39.436,47.19,-7.754
1637862543,1637866800,4257,39.454,45.05,-5.596
1637862543,1637870400,7857,39.562,40.55,-0.988
1637862543,1637874000,11457,37.402,36.39,1.012
1637367267,1637370000,2733,29.896,36.05,-6.154
1637367267,1637373600,6333,28.852,36.16,-7.308
1637367267,1637377200,9933,27.7,35.94,-8.24
1637367267,1637380800,13533,26.008,35.38,-9.372
1637627598,1637629200,1602,22.816,28.96,-6.144
1637627598,1637632800,5202,21.304,28.17,-6.866
1637627598,1637636400,8802,19.216,27.84,-8.624
1637627598,1637640000,12402,16.714,27.95,-11.236
1637779381,1637780400,1019,54.628,58.89,-4.262
1637779381,1637784000,4619,54.628,57.54,-2.912
1637779381,1637787600,8219,53.332,52.7,0.632
1637779381,1637791200,11819,49.354,52.59,-3.236
1637356404,1637359200,2796,36.07,39.76,-3.69
1637356404,1637362800,6396,34.126,37.29,-3.164
1637356404,1637366400,9996,31.732,35.38,-3.648
1637356404,1637370000,13596,28.51,36.05,-7.54
1637963695,1637964000,305,37.416,41.79,-4.374
1637963695,1637967600,3905,36.624,41.11,-4.486
1637963695,1637971200,7505,35.346,41.56,-6.214
1637963695,1637974800,11105,33.816,39.76,-5.944
1637880610,1637881200,590,29.516,35.15,-5.634
1637880610,1637884800,4190,28.67,35.6,-6.93
1637880610,1637888400,7790,27.626,35.71,-8.084
1637880610,1637892000,11390,26.546,33.69,-7.144
1637464865,1637467200,2335,42.944,45.84,-2.896
1637464865,1637470800,5935,42.89,45.28,-2.39
1637464865,1637474400,9535,43.592,45.72,-2.128
1637464865,1637478000,13135,44.24,45.84,-1.6
1637374495,1637377200,2705,32.146,35.94,-3.794
1637374495,1637380800,6305,31.516,35.38,-3.864
1637374495,1637384400,9905,30.688,37.17,-6.482
1637374495,1637388000,13505,29.914,37.74,-7.826
1637837247,1637838000,753,40.188,43.59,-3.402
1637837247,1637841600,4353,41.07,44.6,-3.53
1637837247,1637845200,7953,42.402,43.36,-0.958
1637837247,1637848800,11553,46.416,56.3,-9.884
1637978145,1637978400,255,34.198,39.31,-5.112
1637978145,1637982000,3855,33.298,37.85,-4.552
1637978145,1637985600,7455,32.308,36.16,-3.852
1637978145,1637989200,11055,31.102,36.72,-5.618
1637439577,1637442000,2423,42.762,45.84,-3.078
1637439577,1637445600,6023,40.584,45.5,-4.916
1637439577,1637449200,9623,37.416,45.5,-8.084
1637439577,1637452800,13223,34.158,45.28,-11.122
1637475701,1637478000,2299,43.54,45.84,-2.3
1637475701,1637481600,5899,44.404,46.06,-1.656
1637475701,1637485200,9499,45.196,45.61,-0.414
1637475701,1637488800,13099,45.7,43.59,2.11
1637797442,1637798400,958,48.63,53.26,-4.63
1637797442,1637802000,4558,48.18,52.36,-4.18
1637797442,1637805600,8158,47.532,51.46,-3.928
1637797442,1637809200,11758,46.794,51.01,-4.216
1638025105,1638025200,95,63.768,83.19,-19.422
1638025105,1638028800,3695,64.812,81.5,-16.688
1637743259,1637744400,1141,32.938,36.84,-3.902
1637743259,1637748000,4741,33.424,35.83,-2.406
1637743259,1637751600,8341,33.928,34.47,-0.542
1637743259,1637755200,11941,34.468,39.31,-4.842
1637540781,1637542800,2019,33.222,36.05,-2.828
1637540781,1637546400,5619,32.772,34.25,-1.478
1637540781,1637550000,9219,32.592,33.01,-0.418
1637540781,1637553600,12819,32.628,31.77,0.858
1637970920,1637971200,280,37.236,41.56,-4.324
1637970920,1637974800,3880,36.354,39.76,-3.406
1637970920,1637978400,7480,34.95,39.31,-4.36
1637970920,1637982000,11080,33.636,37.85,-4.214
1637634824,1637636400,1576,21.722,27.84,-6.118
1637634824,1637640000,5176,20.426,27.95,-7.524
1637634824,1637643600,8776,18.86,27.5,-8.64
1637634824,1637647200,12376,16.934,27.39,-10.456
1637537169,1637539200,2031,34.646,37.96,-3.314
1637537169,1637542800,5631,34.07,36.05,-1.98
1637537169,1637546400,9231,33.17,34.25,-1.08
1637537169,1637550000,12831,33.206,33.01,0.196
1637819121,1637820000,879,47.03,47.97,-0.94
1637819121,1637823600,4479,47.192,45.05,2.142
1637819121,1637827200,8079,47.462,45.61,1.852
1637819121,1637830800,11679,48.326,45.61,2.716
1637457639,1637460000,2361,41.472,45.16,-3.688
1637457639,1637463600,5961,41.094,45.5,-4.406
1637457639,1637467200,9561,40.896,45.84,-4.944
1637457639,1637470800,13161,40.392,45.28,-4.888
1637671006,1637672400,1394,29.118,37.17,-8.052
1637671006,1637676000,4994,29.802,72.05,-42.248
1637671006,1637679600,8594,31.71,82.18,-50.47
1637671006,1637683200,12194,34.428,87.13,-52.702
1637631211,1637632800,1589,22.098,28.17,-6.072
1637631211,1637636400,5189,20.676,27.84,-7.164
1637631211,1637640000,8789,18.786,27.95,-9.164
1637631211,1637643600,12389,16.698,27.5,-10.802
1637725199,1637726400,1201,29.772,35.15,-5.378
1637725199,1637730000,4801,29.844,35.38,-5.536
1637725199,1637733600,8401,29.808,37.63,-7.822
1637725199,1637737200,12001,29.79,37.63,-7.84
1637782993,1637784000,1007,54.606,57.54,-2.934
1637782993,1637787600,4607,53.724,52.7,1.024
1637782993,1637791200,8207,50.61,52.59,-1.98
1637782993,1637794800,11807,47.28,52.25,-4.97
1637840860,1637841600,740,38.574,44.6,-6.026
1637840860,1637845200,4340,40.212,43.36,-3.148
1637840860,1637848800,7940,43.776,56.3,-12.524
1637840860,1637852400,11540,49.734,68.11,-18.376
1637443190,1637445600,2410,41.198,45.5,-4.302
1637443190,1637449200,6010,38.912,45.5,-6.588
1637443190,1637452800,9610,36.248,45.28,-9.032
1637443190,1637456400,13210,33.98,44.94,-10.96
1637392557,1637395200,2643,36.208,37.29,-1.082
1637392557,1637398800,6243,36.73,37.06,-0.33
1637392557,1637402400,9843,37.054,36.28,0.774
1637392557,1637406000,13443,38.278,34.92,3.358
1637598697,1637600400,1703,52.682,81.84,-29.158
1637598697,1637604000,5303,51.926,47.19,4.736
1637598697,1637607600,8903,50.522,42.35,8.172
1637598697,1637611200,12503,47.948,39.2,8.748
1637649333,1637650800,1467,21.934,27.39,-5.456
1637649333,1637654400,5067,21.142,27.5,-6.358
1637649333,1637658000,8667,20.17,26.83,-6.66
1637649333,1637661600,12267,19.198,26.38,-7.182
1637848090,1637848800,710,41.506,56.3,-14.794
1637848090,1637852400,4310,44.494,68.11,-23.616
1637848090,1637856000,7910,49.156,77.68,-28.524
1637848090,1637859600,11510,54.718,74.3,-19.582
1638021493,1638021600,107,42.924,72.16,-29.236
1638021493,1638025200,3707,44.382,83.19,-38.808
1638021493,1638028800,7307,47.28,81.5,-34.22
1637385333,1637388000,2667,34.104,37.74,-3.636
1637385333,1637391600,6267,34.266,38.08,-3.814
1637385333,1637395200,9867,34.446,37.29,-2.844
1637385333,1637398800,13467,34.554,37.06,-2.506
1637775769,1637776800,1031,61.916,61.36,0.556
1637775769,1637780400,4631,62.456,58.89,3.566
1637775769,1637784000,8231,62.978,57.54,5.438
1637775769,1637787600,11831,61.628,52.7,8.928
1637750483,1637751600,1117,30.018,34.47,-4.452
1637750483,1637755200,4717,30.738,39.31,-8.572
1637750483,1637758800,8317,32.826,47.75,-14.924
1637750483,1637762400,11917,37.848,-196.6,234.448
1637869773,1637870400,627,34.612,40.55,-5.938
1637869773,1637874000,4227,33.478,36.39,-2.912
1637869773,1637877600,7827,30.346,36.16,-5.814
1637869773,1637881200,11427,28.168,35.15,-6.982
1637638436,1637640000,1564,21.864,27.95,-6.086
1637638436,1637643600,5164,20.766,27.5,-6.734
1637638436,1637647200,8764,19.344,27.39,-8.046
1637638436,1637650800,12364,17.508,27.39,-9.882
1637981757,1637982000,243,32.184,37.85,-5.666
1637981757,1637985600,3843,31.158,36.16,-5.002
1637981757,1637989200,7443,29.988,36.72,-6.732
1637981757,1637992800,11043,28.656,37.17,-8.514
1637757708,1637758800,1092,39.016,47.75,-8.734
1637757708,1637762400,4692,41.392,-196.6,237.992
1637757708,1637766000,8292,45.64,78.13,-32.49
1637757708,1637769600,11892,51.148,80.49,-29.342
1637305743,1637308800,3057,22.802,28.96,-6.158
1637305743,1637312400,6657,21.938,28.51,-6.572
1637305743,1637316000,10257,20.498,27.84,-7.342
1637305743,1637319600,13857,18.212,29.19,-10.978
1637577023,1637578800,1777,22.534,28.96,-6.426
1637577023,1637582400,5377,22.372,33.46,-11.088
1637577023,1637586000,8977,22.282,37.63,-15.348
1637577023,1637589600,12577,24.28,68.56,-44.28
1637345563,1637348400,2837,44.746,46.17,-1.424
1637345563,1637352000,6437,44.926,43.59,1.336
1637345563,1637355600,10037,44.206,41.0,3.206
1637345563,1637359200,13637,39.742,39.76,-0.018
1637580635,1637582400,1765,27.7,33.46,-5.76
1637580635,1637586000,5365,27.772,37.63,-9.858
1637580635,1637589600,8965,29.248,68.56,-39.312
1637580635,1637593200,12565,30.562,81.72,-51.158
1637291282,1637294400,3118,24.154,30.42,-6.266
1637291282,1637298000,6718,22.318,30.09,-7.772
1637291282,1637301600,10318,20.122,29.19,-9.068
1637291282,1637305200,13918,17.53,28.63,-11.1
1637526333,1637528400,2067,38.676,41.79,-3.114
1637526333,1637532000,5667,37.218,40.33,-3.112
1637526333,1637535600,9267,35.85,39.65,-3.8
1637526333,1637539200,12867,34.572,37.96,-3.388
1637522722,1637524800,2078,41.65,44.49,-2.84
1637522722,1637528400,5678,40.858,41.79,-0.932
1637522722,1637532000,9278,38.77,40.33,-1.56
1637522722,1637535600,12878,37.042,39.65,-2.608
1637934796,1637935200,404,31.114,56.3,-25.186
1637934796,1637938800,4004,30.052,70.14,-40.088
1637934796,1637942400,7604,29.458,75.76,-46.302
1637934796,1637946000,11204,28.828,74.07,-45.242
1637678232,1637679600,1368,39.902,82.18,-42.278
1637678232,1637683200,4968,40.55,87.13,-46.58
1637678232,1637686800,8568,41.9,82.18,-40.28
1637678232,1637690400,12168,43.502,52.47,-8.968
1637435965,1637438400,2435,45.334,47.41,-2.076
1637435965,1637442000,6035,44.974,45.84,-0.866
1637435965,1637445600,9635,41.878,45.5,-3.622
1637435965,1637449200,13235,38.152,45.5,-7.348
1637884222,1637884800,578,29.424,35.6,-6.176
1637884222,1637888400,4178,28.434,35.71,-7.276
1637884222,1637892000,7778,27.282,33.69,-6.408
1637884222,1637895600,11378,25.698,31.55,-5.852
1637493762,1637496000,2238,41.02,43.59,-2.57
1637493762,1637499600,5838,42.892,48.31,-5.418
1637493762,1637503200,9438,46.546,74.64,-28.094
1637493762,1637506800,13038,51.442,84.65,-33.208
1637363632,1637366400,2768,31.368,35.38,-4.012
1637363632,1637370000,6368,30.054,36.05,-5.996
1637363632,1637373600,9968,28.542,36.16,-7.618
1637363632,1637377200,13568,27.012,35.94,-8.928
1637999818,1638000000,182,28.936,34.36,-5.424
1637999818,1638003600,3782,28.396,34.14,-5.744
1637999818,1638007200,7382,27.64,33.69,-6.05
1637999818,1638010800,10982,26.812,33.35,-6.538
1637790217,1637791200,983,45.444,52.59,-7.146
1637790217,1637794800,4583,43.878,52.25,-8.372
1637790217,1637798400,8183,41.736,53.26,-11.524
1637790217,1637802000,11783,39.09,52.36,-13.27
1637717974,1637719200,1226,32.596,37.4,-4.804
1637717974,1637722800,4826,32.182,35.49,-3.308
1637717974,1637726400,8426,31.57,35.15,-3.58
1637717974,1637730000,12026,30.922,35.38,-4.458
1638028718,1638028800,82,71.472,81.5,-10.028
1637414230,1637416800,2570,45.79,56.75,-10.96
1637414230,1637420400,6170,48.796,48.54,0.256
1637414230,1637424000,9770,52.918,50.67,2.248
1637414230,1637427600,13370,57.742,50.11,7.632
1637609534,1637611200,1666,34.624,39.2,-4.576
1637609534,1637614800,5266,33.238,36.84,-3.602
1637609534,1637618400,8866,30.664,33.24,-2.576
1637609534,1637622000,12466,27.37,31.77,-4.4
1637761320,1637762400,1080,45.01,-196.6,241.61
1637761320,1637766000,4680,47.566,78.13,-30.564
1637761320,1637769600,8280,51.544,80.49,-28.946
1637761320,1637773200,11880,56.422,85.44,-29.018
1637764932,1637766000,1068,58.928,78.13,-19.202
1637764932,1637769600,4668,60.746,80.49,-19.744
1637764932,1637773200,8268,63.644,85.44,-21.796
1637764932,1637776800,11868,67.19,61.36,5.83
1637714362,1637715600,1238,30.898,36.72,-5.822
1637714362,1637719200,4838,30.142,37.4,-7.258
1637714362,1637722800,8438,29.206,35.49,-6.284
1637714362,1637726400,12038,28.09,35.15,-7.06
1637602310,1637604000,1690,53.712,47.19,6.522
1637602310,1637607600,5290,52.614,42.35,10.264
1637602310,1637611200,8890,50.544,39.2,11.344
1637602310,1637614800,12490,47.682,36.84,10.842
1637844476,1637845200,724,39.196,43.36,-4.164
1637844476,1637848800,4324,41.428,56.3,-14.872
1637844476,1637852400,7924,45.91,68.11,-22.2
1637844476,1637856000,11524,51.814,77.68,-25.866
1637421516,1637424000,2484,48.326,50.67,-2.344
1637421516,1637427600,6084,50.324,50.11,0.214
1637421516,1637431200,9684,52.862,49.55,3.312
1637421516,1637434800,13284,55.562,48.88,6.682
1637584247,1637586000,1753,30.216,37.63,-7.414
1637584247,1637589600,5353,31.116,68.56,-37.444
1637584247,1637593200,8953,32.376,81.72,-49.344
1637584247,1637596800,12553,33.312,84.99,-51.678
1637468477,1637470800,2323,43.484,45.28,-1.796
1637468477,1637474400,5923,43.844,45.72,-1.876
1637468477,1637478000,9523,44.258,45.84,-1.582
1637468477,1637481600,13123,45.734,46.06,-0.326
1637728811,1637730000,1189,30.06,35.38,-5.32
1637728811,1637733600,4789,30.204,37.63,-7.426
1637728811,1637737200,8389,30.33,37.63,-7.3
1637728811,1637740800,11989,30.474,35.94,-5.466
1637184736,1637186400,1664,57.88,56.97,0.91
1637184736,1637190000,5264,55.306,54.95,0.356
1637184736,1637193600,8864,52.21,51.46,0.75
1637184736,1637197200,12464,49.006,47.86,1.146
1637652945,1637654400,1455,23.142,27.5,-4.358
1637652945,1637658000,5055,22.26,26.83,-4.57
1637652945,1637661600,8655,21.342,26.38,-5.038
1637652945,1637665200,12255,20.316,27.05,-6.734
1637551678,1637553600,1922,27.534,31.77,-4.236
1637551678,1637557200,5522,26.976,31.44,-4.464
1637551678,1637560800,9122,26.364,29.86,-3.496
1637551678,1637564400,12722,26.724,30.76,-4.036
1637490150,1637492400,2250,40.566,43.81,-3.244
1637490150,1637496000,5850,41.034,43.59,-2.556
1637490150,1637499600,9450,43.392,48.31,-4.918
1637490150,1637503200,13050,47.694,74.64,-26.946
1637562514,1637564400,1886,25.374,30.76,-5.386
1637562514,1637568000,5486,25.212,29.41,-4.198
1637562514,1637571600,9086,25.608,29.08,-3.472
1637562514,1637575200,12686,25.572,27.84,-2.268
1637721586,1637722800,1214,31.624,35.49,-3.866
1637721586,1637726400,4814,31.444,35.15,-3.706
1637721586,1637730000,8414,31.156,35.38,-4.224
1637721586,1637733600,12014,30.778,37.63,-6.852
1637923959,1637924400,441,19.348,25.81,-6.462
1637923959,1637928000,4041,17.818,28.85,-11.032
1637923959,1637931600,7641,16.072,32.34,-16.268
1637923959,1637935200,11241,14.524,56.3,-41.776
1637736035,1637737200,1165,34.014,37.63,-3.616
1637736035,1637740800,4765,34.482,35.94,-1.458
1637736035,1637744400,8365,34.878,36.84,-1.962
1637736035,1637748000,11965,35.238,35.83,-0.592
1637159341,1637161200,1859,63.45,90.39,-26.94
1637159341,1637164800,5459,67.95,100.4,-32.45
1637159341,1637168400,9059,73.512,98.04,-24.528
1637159341,1637172000,12659,79.074,66.65,12.424
1637454027,1637456400,2373,41.628,44.94,-3.312
1637454027,1637460000,5973,40.62,45.16,-4.54
1637454027,1637463600,9573,39.522,45.5,-5.978
1637454027,1637467200,13173,38.73,45.84,-7.11
1637696294,1637697600,1306,43.248,46.96,-3.712
1637696294,1637701200,4906,42.582,42.13,0.452
1637696294,1637704800,8506,39.918,38.3,1.618
1637696294,1637708400,12106,36.066,36.61,-0.544
1637754095,1637755200,1105,32.382,39.31,-6.928
1637754095,1637758800,4705,33.966,47.75,-13.784
1637754095,1637762400,8305,37.962,-196.6,234.562
1637754095,1637766000,11905,43.542,78.13,-34.588
1637811894,1637812800,906,48.7,50.22,-1.52
1637811894,1637816400,4506,48.97,49.21,-0.24
1637811894,1637820000,8106,49.186,47.97,1.216
1637811894,1637823600,11706,49.708,45.05,4.658
1637381721,1637384400,2679,33.332,37.17,-3.838
1637381721,1637388000,6279,33.35,37.74,-4.39
1637381721,1637391600,9879,33.26,38.08,-4.82
1637381721,1637395200,13479,33.242,37.29,-4.048
1637591472,1637593200,1728,37.15,81.72,-44.57
1637591472,1637596800,5328,37.438,84.99,-47.552
1637591472,1637600400,8928,38.104,81.84,-43.736
1637591472,1637604000,12528,37.888,47.19,-9.302
1637931184,1637931600,416,28.146,32.34,-4.194
1637931184,1637935200,4016,26.85,56.3,-29.45
1637931184,1637938800,7616,25.41,70.14,-44.73
1637931184,1637942400,11216,24.762,75.76,-50.998
1637945632,1637946000,368,62.044,74.07,-12.026
1637945632,1637949600,3968,61.342,48.2,13.142
1637945632,1637953200,7568,60.46,44.49,15.97
1637945632,1637956800,11168,58.948,43.36,15.588
1637952857,1637953200,343,39.006,44.49,-5.484
1637952857,1637956800,3943,38.484,43.36,-4.876
1637952857,1637960400,7543,37.098,42.58,-5.482
1637952857,1637964000,11143,34.272,41.79,-7.518
1637312975,1637316000,3025,22.098,27.84,-5.742
1637312975,1637319600,6625,20.586,29.19,-8.604
1637312975,1637323200,10225,18.408,34.47,-16.062
1637312975,1637326800,13825,17.49,39.54,-22.05
1637316589,1637319600,3011,21.664,29.19,-7.526
1637316589,1637323200,6611,19.936,34.47,-14.534
1637316589,1637326800,10211,18.964,39.54,-20.576
1637316589,1637330400,13811,19.612,47.75,-28.138
1637866158,1637866800,642,38.026,45.05,-7.024
1637866158,1637870400,4242,37.702,40.55,-2.848
1637866158,1637874000,7842,35.902,36.39,-0.488
1637866158,1637877600,11442,31.852,36.16,-4.308
1637905896,1637906400,504,21.918,28.51,-6.592
1637905896,1637910000,4104,20.928,27.5,-6.572
1637905896,1637913600,7704,19.83,27.05,-7.22
1637905896,1637917200,11304,18.354,26.38,-8.026
1637707130,1637708400,1270,30.916,36.61,-5.694
1637707130,1637712000,4870,29.548,35.49,-5.942
1637707130,1637715600,8470,27.784,36.72,-8.936
1637707130,1637719200,12070,25.858,37.4,-11.542
1637349177,1637352000,2823,43.988,43.59,0.398
1637349177,1637355600,6423,43.43,41.0,2.43
1637349177,1637359200,10023,39.938,39.76,0.178
1637349177,1637362800,13623,36.878,37.29,-0.412
1637309360,1637312400,3040,22.894,28.51,-5.616
1637309360,1637316000,6640,21.742,27.84,-6.098
1637309360,1637319600,10240,19.834,29.19,-9.356
1637309360,1637323200,13840,17.26,34.47,-17.21
1637515436,1637517600,2164,59.342,54.28,5.062
1637515436,1637521200,5764,60.134,47.41,12.724
1637515436,1637524800,9364,59.9,44.49,15.41
1637515436,1637528400,12964,58.406,41.79,16.616
